[FAM]
oneclick	1clickdownload
oneclickdownloader	1clickdownload
seven	7ev3n
emper	7ev3n
empercrypt	7ev3n
abbados	abaddonpos
magicscroll	acidbox
axespy	actionspy
spyaction	actionspy
adamantiumthief	adamantiumtheif
lyrics	addlyrics
adgazele	adgazelle
adposhelpmf	adposhel
adopshel	adposhel
adylkuzzminer	adylkuzz
goagendacrypt	agenda
agenda	agendacrypt
comrat	agentbtz
agnsmit	agentsmith
agentesla	agenttesla
agensla	agenttesla
negasteal	agenttesla
spyahmyth	ahmyth
airinstall	airadinstaller
airinstaller	airadinstaller
pralice	alice
projectalice	alice
aliceatm	alice
atmalice	alice
alinaos	alina
alinapos	alina
alinabot	alina
allaplet	allaple
starman	allaple
allcomeclipper	allcome
almalock	almalocker
alma	almalocker
almanhe	almana
alman	almanahe
alphabet	alphabetransomware
deyma	amadey
amnesiae	amnesia
anatovaransom	anatova
anchorbot	anchor
anchorloader	anchor
anchormail	anchor
anchordns	anchor
anchorbotdns	anchordns
andardoor	andariel
gamarue	andromeda
androm	andromeda
wauchos	andromeda
andromcrtd	andromeda
dromedan	andromeda
bladabind	andromeda
gelup	andromut
androxghost	androxgh0st
bankanubistrojan	anubis
anubisstealer	anubis
ginpanubisbank	anubis
ginp	anubis
apocalypseransom	apocalypse
appokrypt	apocalypse
apostrius	apostle
adurk	ardurk
arduk	ardurk
ardunk	ardurk
artur	ardurk
rft	arefty
aria	ariabody
arik	arikkeylogger
arkeistealer	arkei
artfulpi	artfulpie
artra	artradownloader
bitterartra	artradownloader
bitartra	artradownloader
artraloader	artradownloader
ascentloader	ascentorloader
aspxor	asprox
kuluoz	asprox
astasialoader	astasia
async	asyncrat
asyncratnet	asyncrat
athena	athenago
athenrat	athenago
antinza	athenago
atmjackpotx	atmjackpot
jackpot	atmjackpot
ripperatm	atmripper
atmrip	atmripper
atmrippery	atmripper
atrip	atmripper
atmoripper	atmripper
ratavar	avatar
avemariarat	avemaria
maria	avemaria
azeela	azazel
rultazo	azorult
azov	azovwiper
asowwiper	azovwiper
babuklocker	babuk
babyk	babuk
babukcrypt	babuk
rabbad	badrabbit
rabbitnd	badrabbit
beagle	bagle
bbeagle	bagle
beagledt	bagle
balge	bagle
beagleu	bagle
spybahamut	bahamut
bahamutcad	bahamut
bahamt	bahamut
baldrstealer	baldr
baldir	baldr
balkandoor2	balkandoor
balkandoor3	balkandoor
balkan	balkandoor
balkanrat	balkandoor
banditsteal	bandit
banditstealer	bandit
bandok	bandook
bandoo	bandook
bandler	bandook
bbswift	banswift
barbwire	barbie
bartcrypt	bart
bartz	bart
batwiper	batchwiper
nimzloader	bazarnimrod
nimzaloader	bazarnimrod
beastdo	beastdoor
bedep64	bedep
rozena	bedep
bazarbackdoor	beerbot
team9backdoor	beerbot
webber	berbew
padodor	berbew
posbernhard	bernhardpos
neurevt	betabot
biandoor	bianlian
bibi	bibilinux
bifrost	bifrose
socksbot	birddog
nadrac	birddog
socks	birddog
biskvitlib	biskvit
friedex	bitpaymer
bitpayer	bitpaymer
bitpylocker	bitpylock
bitterrat	bitter
b1txor20	bitxor
bitxo	bitxor
blk	black
basta	blackbasta
blackbas	blackbasta
blkbyte	blackbyte
blackcatalphv	blackcat
blackofi	blackcoffee
blacken	blackenergy
fonten	blackenergy
blakken	blackenergy
blaken	blackenergy
blacole	blackhole
blacoleref	blackhole
blackkingdomransomware	blackkingdom
bkingdome	blackkingdom
blacklot	blacklotus
blackmat	blackmatter
krbanker	blackmoon
blacknetrat	blacknet
blacknixrat	blacknix
blackrevolution	blackrev
bkrota	blackrota
blackheart	blackrouter
shakblades	blackshades
blindransomware	blind
napoleon	blind
dratzarus	blindingcan
blindingcan00	blindingcan
bluestealer	blustealer
smsbomber	bomber
borat	boratrat
brambulri	brambul
botb	breakoutthebox
brothbo	breakoutthebox
rontokbr	brontok
browserfox	browsefox
brsecmone	brsecmon
bruteratelc4	bruteratel
tibrun	brutpos
posbrut	brutpos
bitcovar	btcware
buerloader	buer
buerak	buer
rustybuer	buer
buran	buhtrap
ratopak	buhtrap
bumbleloader	bumblebee
bumble	bumblebee
shellsting	bumblebee
bnodlero	bundlore
bunitucrypt	bunitu
bunnyldr	bunnyloader
butirat	buterat
c99	c99shell
cabart	cabby
cabhot	cabby
cactustorch	cactus
cain	cainabel
campong	campoloader
canbalral	cannibalrat
anunak	carbanak
sekur	carbanak
cardinal	cardinalrat
appetite	careto
themask	careto
carrobat	carrotbat
chatchamas	catchamas
catchman	catchamas
catelitesbot	catelites
cdrthf	cdrthief
cerebrus	centerpos
centrumdownloader	centrumloader
zerber	cerber
crbr	cerber
crbrencryptor	cerber
firecerb	cerber
cerbercrypt	cerber
hpcerber	cerber
cebruser	cerberus
chaisht	chainshot
netchaos	chaos
chaperone	chaper
crypchim	chimera
chopper	chinachopper
chinoxybackdoor	chinoxy
chtonic	chthonic
cinoshistealer	cinoshi
citear	citeary
broomstick	cleanuploader
cleanup	cleanuploader
clipper	clipbanker
sysraw	clipsa
sysrawstealer	clipsa
klopransom	clop
clopransom	clop
ploc	clop
cl0p	clop
clopcrypt	clop
cloudlook	cloudduke
minidionis	cloudduke
clouduke	cloudduke
cloudmens	cloudmensis
snoopy	cloudsnooper
bruteshed	cmsbrute
meciv	cmstar
mecive	cmstar
coala	coalabot
cobalt	cobaltstrike
cobeacon	cobaltstrike
meterpreter	cobaltstrike
coolpants	cobint
cloudlock	coldlock
coldrootrat	coldroot
colibriloader	colibri
combus	combos
chinch	comrat
cduit	conduit
kido	conficker
downadup	conficker
downad	conficker
dexbia	conime
bromall	conime
getshell	connectback
conticrypt	conti
monti	conti
whiteout	contopee
bankshot	copperhedge
manuscrypt	copperhedge
autophyte	copperhedge
coresh	coreshell
coronavi	corona
coronavirusransomware	coronavirus
corona	coronaworm
systembc	coroxy
cosmicdukek	cosmicduke
cotx	cotxrat
cwrsnail	cowersnail
cozer	cozycar
cr1ptt	cr1ptt0r
cr1pttor	cr1ptt0r
creativeupdater	creativeupdate
bugat	cridex
feodo	cridex
crimson	crimsonrat
scarimson	crimsonrat
crimsonnet	crimsonrat
crimsonratfc	crimsonrat
seedoor	crimsonrat
rcs	crisis
crisisht	crisis
cossder	crossrider
crori	crossrider
cheesetray	crowdedflounder
crylock	cryakl
crycryptor	crycrypt
lockercrycryptor	crycrypt
cute	crypcute
cutecrypter	crypcute
crypen	crypren
torrentlocker	crypt0l0cker
teerac	crypt0l0cker
cryptolocker	crypt0l0cker
crilock	crypt0l0cker
cryptlock	crypt0l0cker
cryplock	crypt0l0cker
cryptolock	crypt0l0cker
crypteight	crypt888
choda	crypt888
fortrypt	cryptofortress
jokryp	cryptojoker
cryptjoker	cryptojoker
cryptfile2	cryptomix
shuffler	cryptoshuffler
cryptoshuf	cryptoshuffler
cliptoshuffler	cryptoshuffler
cryptodef	cryptowall
crowti	cryptowall
cryptodefense	cryptowall
crypwall	cryptowall
cryptowall3	cryptowall
cryptowall4	cryptowall
cwall	cryptowall
cryptprojectxxx	cryptxxx
waltrix	cryptxxx
exxroute	cryptxxx
csdi	csdimonetize
csharpsploit	csharpstreamer
sharps	csharpstreamer
cukiegrabcrx	cukiegrb
cusloader	customerloader
atmletcut	cutletmaker
cutlet	cutletmaker
atmcutsteal	cutletmaker
atmcutlet	cutletmaker
cutletatm	cutletmaker
pss	cyberpss
pycerine	cyperine
cystdownloader	cyst
cystea	cyst
taleret	dalgan
danabotent	danabot
danbot	danabot
fynloski	darkcomet
darkkomet	darkcomet
dcrat	darkcrystal
eqdarkpulsar	darkpulsar
darkradbot	darkradiation
cryptodarkrubix	darkrubix
darkshads	darkshades
dshades	darkshades
darkst	darkstrat
darkteq	darktequila
darkrace	darktrace
darktrackrat	darktrack
zollard	darlloz
muirim	daserf
nioupale	daserf
delimeat	daxin
rpcdcom	dcom
dosia	ddosia
detbosit	deadwood
dealplycrtd	dealply
dealfly	dealply
decbal	decebal
decibal	decebal
decaf	deecaf
defraycrypt	defray
glushkov	defray
deimosc2	deimos
dominicus	deimos
capibar	deliverycheck
delpstats	delphstats
soundbite	denis
dienes	denis
dereilock	derialock
codoso	derusbi
c0d0s0	derusbi
c0d0so0	derusbi
poxters	dexter
dextr	dexter
crysis	dharma
wadhrama	dharma
crusis	dharma
gorynch	diamondfox
gorynych	diamondfox
diamondfoxcrystal	diamondfox
dinodasrat	dinodas
dinwoodaattc	dinwod
redsalt	dipsind
discordia	discordiaminer
javadispcash	dispcash
atmdispcash	dispcash
dispcashbr	dispcash
adamlock	diztakun
downloadhelper	dlhelper
helper	dlhelper
dmalock	dmalocker
madlocker	dmalocker
dmalockr	dmalocker
dnschanger	dnschange
dnspinoage	dnspionage
agentdrable	dnspionage
dockset	dockster
docster	dockster
domainiq	domaiq
donimo	domino
dopplepaymer	doppelpaymer
doppler	doppelpaymer
ruskill	dorkbot
shelma	dorshel
dot	dotransom
doublezerowiper	doublezero
fiberlake	doublezero
delphacy	downdelph
delphocy	downdelph
dowadmin	downloadadmin
downadmin	downloadadmin
downloadmin	downloadadmin
downloadasist	downloadassistant
assistant	downloadassistant
downloadassist	downloadassistant
downloaderguide	downloadguide
downguide	downloadguide
drixed	dridex
hpdridex	dridex
doppeldridex	dridex
toshliph	driftpin
agentorm	driftpin
oceandrive	driveocean
dumaru	dumador
duqu2	duqu
duqudriver	duqu
escad	duuzer
wildpositron	duuzer
qfas	duxfas
dynarat	dynamicrat
dynrat	dynamicrat
dyreza	dyre
dyzap	dyre
dyranges	dyre
battdil	dyre
termite	earthworm
echoraix	ech0raix
qnapcrypt	ech0raix
egregorransom	egregor
eregorcrypt	egregor
ehdoor	ehdevel
eleanr	eleanor
elanor	eleanor
elecfish	electricfish
elctrrat	electrorat
electro	electrorat
esile	elise
deselia	elise
elisea	elise
elmachetedropper2022	elmachete
emsry	emissary
emotetu	emotet
emotetc	emotet
emotetw	emotet
emotetcrypt	emotet
emotetent	emotet
emotetedcryptc	emotet
hpemotet	emotet
emud	emudbot
enigma	engimastealer
entropyr	entropy
blackcocaine	epsilonred
epsired	epsilonred
blackcoca	epsilonred
equdrug	equationdrug
eqdrug	equationdrug
equated	equationdrug
erbiumstealer	erbium
elferebus	erebus
rootkitspecter	especter
sokuxuan	eszjuxuan
eterock	eternalrocks
eternalrock	eternalrocks
eterocks	eternalrocks
eternityransomware	eternity
eternity	eternityclipper
eternsteal	eternitystealer
riptide	etumbot
bankeventbot	eventbot
bunevil	evilbunny
evlgnm	evilgnome
evital	evrial
evrialstealer	evrial
sabresac	excalibur
sabres	excalibur
zala	exforel
xmas	exmas
exodus	exod
exodusspy	exod
xpiro	expiro
expiromvb	expiro
edownloader	expressdownloader
express	expressdownloader
expressfiles	expressdownloader
xtrat	extremerat
pyramid	eyepyramid
fakecall	fakecalls
fakgram	faketelegram
faketgram	faketelegram
fakecry	fakewannacry
fakewcry	fakewannacry
fantom	fantomcrypt
fasthookpos	fastpos
frp	fastreverseproxy
sainbox	fatalrat
nofear	fearso
tomyjery	felismus
fenomen	fenomengame
formerfirstrat	ffrat
ficker	fickerstealer
fileiceransom	fileice
finfisher	finspy
finfish	finspy
fishfin	finspy
firser	firseria
firseriainstaller	firseria
fiseria	firseria
flame2	flame
flamer	flame
skywiper	flame
ammyrat	flawedammyy
flawedammy	flawedammyy
gracewire	flawedgrace
floki	flokibot
agentflowershop	flowershop
fixflo	floxif
floxliba	floxif
floxlib	floxif
bankflubot	flubot
cabassous	flubot
polph	flubot
polphc	flubot
flystud	flystudio
spyflytrap	flytrap
berrof	fobber
fonixcrypt	fonix
fonixcrypter	fonix
fontlak	fontonlake
forbiks	forbix
xloader	formbook
fortunecookie	fortunecrypt
freenkiloader	freenki
frzfrog	fritzfrog
quimitchin	fruitfly
soccrypt	fsociety
fujack	fujacks
fujinamarat	fujinama
bankfunkybot	funkybot
wroba	funkybot
wrobascf	funkybot
funmood	funmoods
funnydreambackdoor	funnydream
bashlite	gafgyt
gandcrypt	gandcrab
gandcrab4	gandcrab
ransomgandcrab	gandcrab
gandcrabv4	gandcrab
grandcrab	gandcrab
hpgandcrab	gandcrab
gandcrab04	gandcrab
gndcrab	gandcrab
gandcrab02	gandcrab
crab4	gandcrab
gandcrabih	gandcrab
gandcrab01	gandcrab
gandcrab03	gandcrab
gandcrab05	gandcrab
gandcrab06	gandcrab
gandcrab07	gandcrab
gandcrab08	gandcrab
gandcrab09	gandcrab
gandcrab10	gandcrab
garrantdecrypt	garrantydecrypt
garrandec	garrantydecrypt
garranty	garrantydecrypt
trickler	gator
gain	gator
gcleanerpmf	gcleaner
gclean	gcleaner
andromut	gelup
geonei	genieo
getandgo	get2
friendspeak	get2
getmypasspos	getmypass
gh0strat	gh0st
zegost	ghostrat
shellclient	ghostshell
gibberish	gibrish
guiwin	ginwui
ginwni	ginwui
globeransom	globe
fakeglobe	globeimposter
purgen	globeimposter
gimposter	globeimposter
eagle	glodeagl
goldeneagle	glodeagl
goldeagle	glodeagl
goldene	glodeagl
goldeneagl	glodeagl
gloox	glooxmail
gluptebaproxy	gluptebaproxy
gobotkr	gobot
gobot2	gobot
godzillaloader	godzilla
dagozill	godzilla
gozla	godzilla
godzilia	godzilla
godzillawebshell	godzilla
goldenhelper	goldenspy
sunshuttle	goldmax
gomorrahstealer	gomorrah
spygoontact	goontact
otlard	gootkit
waldek	gootkit
talalpek	gootkit
xswkit	gootkit
gpcoder	gpcode
gplayedtrojan	gplayed
graphdrop	graphicalproton
grafayt	graphite
frameworkpos	gratefulpos
gravity	gravityrat
greeodode	greendispenser
grayenergy	greyenergy
grifthorsescf	grifthorse
guerilla	guerrilla
astaroth	guildma
cloudeye	guloader
h1n1	h1n1loader
hackdef	hacdef
hackerdefender	hacdef
hxdef	hacdef
hackdef73	hacdef
hackdefender	hacdef
kms	hackkms
hades	hadeslocker
thanos	hakbit
hackbit	hakbit
tdiscoverer	hammertoss
chanitor	hancitor
hancitordwn	hancitor
hanticor	hancitor
hanthie	handofthief
hanove	hangover
hangver	hangover
havexnetscan	havex
havexrat	havex
hawkeyekeylogger	hawkeye
haweye	hawkeye
hawkshawspy	hawkshaw
hellokit	hellokitty
kitty	hellokitty
hkitty	hellokitty
herher	helminth
herlog	helminth
msilheracles	heracles
crypherbst	herbst
hermesransomware	hermes
hermesran	hermes
hermez	hermes
herms	hermes
hrmetcwipr	hermeticwiper
foxblade	hermeticwiper
herpbot	herpes
heyokamod	heyoka
hiatusr	hiatusrat
cryptear	hiddentear
hiddentears	hiddentear
tear	hiddentear
teardrop	hiddentear
hidwasp	hiddenwasp
hdnwsp	hiddenwasp
hikiti	hikit
hiki	hikit
hyldacrypt	hildacrypt
hilda	hildacrypt
hinata	hinatabot
gohive	hive
filcodrhive	hive
vault8hive	hive
hangman	hoplight
horus	horuseyes
dunihi	houdini
dinihou	houdini
hworm	houdini
htran2	htran
hunter	hunterstealer
sarhust	hussarini
endcmd	hussarini
helloworld	hworld
hyperscrptl	hyperscrape
hypscrap	hyperscrape
hyperscrap	hyperscrape
icedld	icedid
erifeci	icefire
lcnanker	icnanker
iisn	iisniff
iismod	iisniff
iisniffer	iisniff
isniffer	iisniff
iistealer	iisniff
imminentmonitor	imminent
imminentrat	imminent
immirat	imminent
imminentmonitorrat	imminentmonitor
imuleruploader	imuler
inc	incransom
raninc	incransom
indigo	indigodrop
crashoverride	industroyer
industroyer2	industroyer
industroye	industroyer
infinitycrypt	infinitylock
innaputrat	innaput
installmonstr	installmonster
monster	installmonster
instmonster	installmonster
imonster	installmonster
installmon	installmonster
monstruos	installmonster
isntallmonster	installmonster
installmon2	installmonster
invstealer	invictastealer
iparmor	ipamor
issacwiper	isaacwiper
lsmdoor	ismdoor
istartsurfinstaller	istartsurf
startsurf	istartsurf
jackal	jackalcontrol
vjadtre	jadtre
wapomi	jadtre
jaffrans	jaff
jaffcrypto	jaff
crypjaff	jaff
jaffcrypt	jaff
ransomjaff	jaff
jaku2vdb	jaku
jakuvdb	jaku
jhyde	jakyllhyde
ejoralin	janeleiro
janela	janelrat
jason	jasonbrute
jhrat	jhonerat
jigsawlocker	jigsaw
spyjoker	jokerspy
joker	jokerspy
jiripbot	jripbot
jsp	jsprat
jspbckdr	jsprat
jushed	juched
jpotato	juicypotato
juicyptato	juicypotato
chaos	kaiji
katien	kaiten
maildropper	karkoff
cactuspipe	karkoff
oilyface	karkoff
karmacrypt	karma
sandr	kasandra
neutrino	kasidet
mwzlesson	kasidet
casdet	kasidet
kasper	kasperagent
kpot	kbot
bolek	kbot
bolik	kbot
kbotrep	kbot
bazarloader	kegtap
bazaloader	kegtap
team9loader	kegtap
bazdor	kegtap
beerbot	kegtap
kerangerransom	keranger
ransomkeranger	keranger
keyranger	keranger
korkerds	kerberods
ratkevdroid	kevdroid
keymar	keymarble
khalesipmf	khalesi
disakil	killdisk
lazaruskilldisk	killdisk
kimsuk	kimsuky
kingmine	kingminer
kleptoparasitestealer	kleptoparasite
klingon	klingonrat
autokms	kmsauto
kmsactivator	kmsauto
knobotcad	knobot
knot	knotedcrypt
hiddentearkoko	kokokrypt
kolabc	kolab
virkonni	konni
konny	konni
koni	konni
nokki	konni
adkoob	koobcafe
bisonal	korlia
koutdoor	koutodoor
kotver	kovter
novter	kovter
hpkovter	kovter
kovtercrtd	kovter
kraken	krakencryptor
krakenb	krakencryptor
krakryp	krakencryptor
krakenkeylogger	krakenstealer
krasuerat	krasue
osiris	kronos
kronosbot	kronos
konus	kronos
kkrunchy	krunchy
kuikdelivery	kuik
golad	lady
coloredlambert	lambert
plexor	lambert
laplasclip	laplas
laplasstealer	laplas
laplaceclipper	laplas
antilam	latinus
leshiy	lechiffre
backspace	lecna
lecnaback	lecna
legendmir	legmir
lemir	legmir
liev	leivion
moonlight	lightmoon
noonlight	lightmoon
lightningstealer	lightning
lightriver	lightspy
ligsetrac	ligsterac
lilocked	lilock
lime	limerat
limeratnet	limerat
citrate	limerat
liquor	liquorbot
litehttpbot	litehttp
lockbitcrypt	lockbit
lohbit	lockbit
lockbit3	lockbit
rslockbit	lockbit
lckbitrnsm	lockbit
goga	lockergoga
gogalocker	lockergoga
lockergogari	lockergoga
lockycrypt	locky
hplocky	locky
pylocky	locky
lockydecryptor	locky
loda	lodarat
loadarat	lodarat
nymeria	lodarat
loadinfo	lodeinfo
lojack	lojax
doubleagent	lojax
doubeagent	lojax
dblagnt	lojax
loki	lokibot
lokipws	lokibot
loo	loocipher
iloveyou	loveletter
lovelet	loveletter
luckycatrat	luckycat
luminosityrat	luminositylink
luminrat	luminositylink
lumma	lummastealer
lunacrypt	luna
lyceumhttpbackdoordotnet	lyceum
lyceumdnsbackdoordotnet	lyceum
lyceumhttpbackdoorgolang	lyceum
macawlocker	macaw
macran	macransom
angryangel	madangel
madang	madangel
malaga	magala
gamania	magania
magglqul	maggie
sqlmaggie	maggie
magni	magniber
makadocs	makadoc
maktublocker	maktub
takbum	maktub
takabum	maktub
hddcryptor	mamba
hddcrypt	mamba
mambretor	mamba
mambaransom	mamba
mamichanger	mami
msilmamut	mamut
cryptohost	manamecrypt
spymandrake	mandrake
mandrakeamt	mandrake
manjusak	manjusaka
manjsk	manjusaka
margulasnet	margulasrat
jokemars	marsjoke
bmasskeylogger	masslogger
matrixransom	matrix
mytreex	matrix
matryos	matryosh
matryoshkarat	matryoshka
trustezeb	matsnu
maui	mauicrypt
clientmaximus	maximus
mazeransom	maze
mazedec	maze
chacha	maze
mbrlocker	mbrlock
merde	medre
medusaransom	medusalocker
medusa	medusalocker
medusareborn	medusalocker
cortex	megacortex
megumi	megumin
melcoz	mekotio
mercurialgrabber	mercurial
mercuriafc	mercurial
mercu	mercurial
mercugrab	mercurial
myrddin	merlin
casbaneiro	metamorfo
metamorfo2	metamorfo
metasteal	metastealer
mewsei	mewsspy
mgmbot	mgbot
blame	mgbot
miansha	miancha
microbd	microbackdoor
midrash	midrashim
mediyes	miep
microcin	mikroceen
micrin	mikroceen
mimipet	mimikatz
mikatz	mimikatz
mimikatz64	mimikatz
zhmimikatz	mimikatz
katzimi	mimikatz
miniasroot	miniasp
minia	miniasp
minidukeri	miniduke
miragefox	mirage
persirai	mirai
miraiddos	mirai
mirroblast	mirrorblast
mikhail	mischa
redom	modernloader
dbatloader	modiloader
natsoloader	modiloader
modpipepos	modpipe
mospos	modpos
yebot	moker
tilon	moker
moleransomware	mole
moleransom	mole
molecrypto	mole
moneymess	moneymessage
moneymsg	moneymessage
monokle	monocle
mt3	montysthree
moonwnd	moonwind
mrophine	morphine
mortislocker	mortis
mosaic	mosaicregressor
moserpas	moserpass
softomate	mostofate
crosswalk	motnug
tommygun	motnug
quantumlocker	mountlocker
dagonlocker	mountlocker
mountlock	mountlocker
mrac	mracrypt
multigrainpos	multigrain
multigraincrtd	multigrain
multigpos	multigrain
mplug	multiplug
multvrz	multiverze
mebromi	mybios
backupmypc	mypcbackup
necromorph	n3cr0m0rph
freakout	n3cr0m0rph
horcrux	nagini
noancooe	nanocore
nancrat	nanocore
nanoco	nanocore
nanobot	nanocore
nancat	nanocore
nanocor	nanocore
solarbot	napolar
ncctrojannet	ncctrojan
necursmail	necurs
nephilim	nefilim
neficrypt	nefilim
nemain	nemim
neobar	neoreklami
nerbianrat	nerbian
neshuta	neshta
neshtab	neshta
fetnilter	netfilter
netrepserkeylogger	netrepser
netsup	netsupport
netsupportmanager	netsupport
netsupportmanagerrat	netsupport
mailto	netwalker
netwiredrc	netwire
netwired	netwire
wirenet	netwire
netweird	netwire
netwrd	netwire
netwrdrc	netwire
netweirdrc	netwire
lightneuron	neuron
darkneuron	neuron
kasidet	neutrino
neutrinobot	neutrino
neutrinopos	neutrino
hpkasidet	neutrino
neupos	neutrino
kaisdet	neutrino
edanav	nevada
newcorerat	newcore
posnewt	newposthings
nextmanhistorystealer	nextmanhistory
historystealer	nextmanhistory
grobios	ngioweb
nimpl	nimplant
bladabindi	njrat
bladabin	njrat
bbindi	njrat
bladab	njrat
hpbladabi	njrat
bladabi	njrat
ratenjay	njrat
noa	noabot
nocturnalstealer	nocturnal
nodera	nodejsransom
expetr	notpetya
nyetya	notpetya
expetya	notpetya
eternalpetya	notpetya
npetya	notpetya
nonpetya	notpetya
petrwrap	notpetya
petyawrap	notpetya
nukespeed	nukesped
atmnvisospit	nvisospit
nymaim2	nymaim
oblique	obliquerat
obliqrat	obliquerat
ocelotus	oceanlotus
rctopus	octopus
octopusscanner	octopus
octosca	octopus
eqoddjob	oddjob
onliner	oliner
olydest	olympicdestroyer
olympicdestroy	olympicdestroyer
olydestroy	olympicdestroyer
olympic	olympicdestroyer
olympicdistroyer	olympicdestroyer
omni	omnirat
onaht	onhat
onlinegame	onlinegames
onlinegames3	onlinegames
olgames	onlinegames
candyopen	opencandy
opesup	opensupdater
optimizer	optimizerpro
superoptimizer	optimizerpro
optimum	optimuminstaller
orcus	orcusrat
orcusrot	orcusrat
ordinypt	ordin
germanwiper	ordin
orignlgr	originbot
originbotnet	originbot
origlog	originlogger
orpc	orpcbackdoor
oskistealer	oski
babax	osno
osnostealer	osno
babaxstealer	osno
osnocrypt	osno
qusaban	ousaban
ovidiystealer	ovidiy
yidivo	ovidiy
luckyowa	owaauth
ozonerat	ozone
trioxygen	ozone
pownyshell	p0wnyshell
ponyshell	p0wnyshell
crydap	padcrypt
packchat	pakchat
pandastealer	pandasteal
paradiesclipper	paradies
parallaxrat	parallax
paralaxrat	parallax
pate	parite
pay2keyransom	pay2key
mycleanpc	pcclean
pcsurveylocker	pclocker
surveylock	pclocker
chrysaor	pegasus
pepperat	peppyrat
peppy	peppyrat
perinet	perion
msilperseus	perseus
petr	petya
cryptopetya	petya
ransompetya	petya
aptphantomlance	phantomlance
smanager	phantomnet
phemedronestealer	phemedrone
phemsteal	phemedrone
philadelphiaransom	philadelphia
trik	phorpiex
gziploader	photoloader
pingpul	pingpull
pinkbot	pink
cookiecutter	pirpi
shotput	pirpi
backboot	pitou
pxstealr	pixstealer
play	playcrypt
playde	playcrypt
pleed	plead
elfplead	plead
ploutusatm	ploutus
plotus	ploutus
korplug	plugx
gulpix	plugx
sogu	plugx
tigerplug	plugx
plutor	pluto
pngload	pngloader
poison	poisonivy
pivy	poisonivy
spivy	poisonivy
poisoniv	poisonivy
shadowpad	poisonplug
bairlay	poisonplug
pogotear	pokemongo
pokemong	pokemongo
solarmarker	polazert
polazer	polazert
polazertnet	polazert
deimos	polazert
jupspy	polazert
jupyter	polazert
yellowcockatoo	polazert
polipos	polip
chily	polyvice
vicsociety	polyvice
vicesociety	polyvice
fareit	pony
fareitvb	pony
ponystealer	pony
ponik	pony
ponyrat	pony
poohmilkloader	poohmilk
popcorntym	popcorntime
corncrypt	popcorntime
lowkey	portreuse
poshcc	poshc2
poslogr	poslurp
plotso	postlo
poul	poullight
poulightstealer	poullight
poulightnet	poullight
poullightstealer	poullight
povlsomware	povlsom
powerliks	poweliks
powliks	poweliks
pbrace	powerbrace
powduke	powerduke
poweduke	powerduke
powshower	powershower
powspritz	powerspritz
powermud	powerstats
covic	powgoop
powtgoop	powgoop
powemet	powmet
predatorthethief	predator
prestigeransom	prestige
filecoderprestige	prestige
pricefountain	prifou
princess	princesslocker
privlog	privatelog
woodin	projectwood
prometeiauxiliarymodule	prometei
proton	protonrat
psix	psixbot
psloggr	pslogger
pubnub	pubnubrat
pospunk	punkeypos
punkey	punkeypos
patpoopy	pupy
pupyrat	pupy
fuporflex	purplefox
fuporplex	purplefox
prolock	pwndlocker
pwnd	pwndlocker
pwndlock	pwndlocker
pkybot	pykbot
pykse	pykspa
skyper	pykspa
xwo	pyxwo
qqaccelex	qaccel
xallar	qarallaxrat
qakbot	qbot
quakbot	qbot
pinkslipbot	qbot
pinksbot	qbot
qbotcore	qbot
qilincrypt	qilin
qnode	qnodeservice
qq	qqrob
qqlogger	qqrob
qqpass	qqrob
qqthief	qqrob
qqware	qqrob
pliskal	quantloader
quant	quantloader
quasarrat	quasar
cinarat	quasar
quasarnet	quasar
powerpool	queenofhearts
popool	queenofhearts
r77	r77rootkit
raccoon	raccoonstealer
racealer	raccoonstealer
racoon	raccoonstealer
mohazo	raccoonstealer
recordbreaker	raccoonstealer
crypradam	radamant
radam	radamant
ragnar	ragnarlocker
ragnarok	ragnarlocker
ragarlocke	ragnarlocker
redyms	ramdo
rmnet	ramnit
ramnitplugin	ramnit
nimnul	ramnit
rmndrp	ramnit
numnul	ramnit
ramnitnna	ramnit
ramit	ramnit
ramnif	ramnit
fakelock	ranscam
falock	ranscam
fakeransomdel	ranscam
exx	ransomexx
ransomexx2	ransomexx
rapid	rapidransomware
rapidransom	rapidransomware
raroger	rarog
rrobin	raspberryrobin
raspobin	raspberryrobin
powerratankba	ratankba
vermin	ratvermin
vermrat	ratvermin
cybergate	rebhip
redalph	redalpha
rtm	redaman
redenergystealer	redenergy
redlivs	redleaves
redlinestealer	redline
fbstealer	redline
reline	redline
redlinenet	redline
zupdax	redsip
regret	regretlocker
rekoob	rekoobe
relevant	relevantknowledge
remcosrat	remcos
socmer	remcos
rescoms	remcos
cachemoney	remexi
rms	remotemanipulator
remosys	remotemanipulator
cremes	remsec
remsecstrider	remsec
remseckd	remsec
dok	retefe
xdok	retefe
revengerat	revenge
sodinokibi	revil
sodin	revil
sodinokib	revil
sodinok	revil
sodino	revil
elfrexddos	rex
rhino	rhinocrypt
bankriltok	riltok
robbinhood	robin
robinhood	robin
rokkulck	rokku
dogcall	rokrat
rombertikhqc	rombertik
romcom	romcomrat
rook	rookcrypt
poorvirus	roopirs
rotocrypt	rotorcrypt
msorover	rover
mayachok	rovnix
cidox	rovnix
royalransomware	royalransom
8tdropper	royalroad
rrtserv	rrtserver
rtmlckr	rtmlocker
rubeus64	rubeus
rubin	rubinurd
rucrypt	ruransom
rurtar	rurktar
rcsu	rurktar
rustbkt	rustbucket
newrest	rustock
rustnt	rustock
ryukran	ryuk
ruyk	ryuk
ryuk3	ryuk
ryukcrypt	ryuk
ryukransom	ryuk
ryukstealer	ryuk
ryspy	ryuk
sagecrypt	sage
sagelocker	sage
sage2	sage
sageransom	sage
rssage	sage
sagrunex	sagerunex
amatias	saitama
sakularat	sakurel
salicode	sality
salitystub	sality
virussality	sality
salload	sality
samsa	samas
ransmsam	samas
filecodersamas	samas
samas	samsam
crypsam	samsam
samsamcrypt	samsam
sancmed	sanctionedmedia
sandrat	sandrorat
kasandra	sandrorat
nransom	sapnupuas
sapphirenet	sapphirestealer
satan	satana
satancrypt	satana
watchman	sbwatchman
scarabey	scarab
scarabransom	scarab
seadaddy	seaduke
seadad	seaduke
seadask	seaduke
ssalt	seasalt
1xxbot	sectoprat
asatafar	sectoprat
arechclient	sectoprat
secptoprat	sectoprat
sectop	sectoprat
azzy	sedreco
silvertor	sepsys
detox	serpico
detoxcrypt	serpico
bacservhelper	servhelper
troldesh	shade
ransomshade	shade
shadowhm	shadowhammer
shakstiler	shakti
disttrack	shamoon
disttrac	shamoon
karsh	shark
sharkbotscf	sharkbot
banksharkbot	sharkbot
shpmapexc	sharpmapexec
sharpkatz	sharpmapexec
srdi	shellrdi
shipup	shipshape
shitup	shipshape
shoudi	shodi
shohdi	shodi
shopper	shopperz
caphaw	shylock
capchaw	shylock
caphew	shylock
scramblecross	sidewalk
h0lygh0st	siennapurple
holyghost	siennapurple
turlasilentmoon	silentmoon
silly	sillyp2p
slhback	siluhdur
shlback	siluhdur
slisp	silversparrow
slvspr	silversparrow
taidoor	simbot
sinimast	sinimasest
skimernc	skimer
skimerwc	skimer
skimmer	skimer
wintrim	skintrim
vilers	sliver
queenofclubs	slothfulmedia
smlsieve	smallsieve
mokes	smokeloader
smokebot	smokeloader
dofoil	smokeloader
sharik	smokeloader
smokeload	smokeloader
ekoms	smokeloader
404keylogger	snakekeylogger
snakehose	snakelocker
snakeransom	snakelocker
snara	snarasite
snare	snarasite
ransomwaresnc	snc
sonja	snojan
socelars	socstealer
soft32	soft32downloader
softonicdownloader	softonic
solidbitcrypt	solidbit
solternpmf	soltern
elkern	soltern
systro	soltern
sytro	soltern
sombrat	sombra
partyticket	sonicvote
paryticket	sonicvote
rysaoa	soraya
soyara	soraya
sangfor	sorefang
soul	soulsearcher
banksova	sova
torte	spamtorte
spark	sparkrat
upspeak	speakup
spectrerat	spectre
speadear	spedear
speedupmypc	speedingupmypc
zeussphinx	sphinx
springtech	spigot
sporaransom	spora
bprotect	sprotector
bprotector	sprotector
pctool	sprotector
eyestye	spyeye
spyeyes	spyeye
spygnat	spygnat
spynote	spymax
squirelwaffle	squirelwaffle
squaffle	squirrelwaffle
talinslocker	stalinlocker
stampedo	stampado
stampa	stampado
canwhale	starwhale
crazymango	stealthmango
sthsoldier	stealthsoldier
steahide	steamhide
stlcog	steelcorgi
stiller	stillerx
stone	stoned
dropshot	stonedrill
stopcrypt	stop
storm	stormattack
stowproxy	stowaway
strela	strelastealer
streal	strelastealer
strifewater	strifewaterrat
sugarcrypt	sugar
sorcal	sunorcal
sutersuch	sutersu
svcrspy	svcready
skyipot	sykipot
acknys	synack
ransomsynack	synack
syncrypt	synccrypt
hyperssl	sysupdate
talentrat	talrat
tohnichi	targetcompany
mallox	targetcompany
xallom	targetcompany
fargo	targetcompany
targetcomp	targetcompany
tarsipmoon	tarsip
invoketater	tater
taurus	taurusstealer
alureon	tdss
tdl4	tdss
olmarik	tdss
pihar	tdss
tdsserv	tdss
tidserv	tdss
packtdss	tdss
finteam	teambot
teamfostealer	teambot
teledoor	telebot
tcrypt	telecrypt
telludpass	tellyouthepass
telupass	tellyouthepass
cedar	temptingcedar
cryptnet	tencrypt
tescrypt	teslacrypt
cryptesla	teslacrypt
hpcryptesla	teslacrypt
teslacryptpacker	teslacrypt
teslacrypt4	teslacrypt
bitman	teslacrypt
alphabot	thanatos
thanatosransom	thanatos
tigerlite	tigerrat
tinybanker	tinba
tina	tinba
tinbakd	tinba
tinynuke	tinukebot
tinukebot	tinynuke
tinuke	tinynuke
nukebot	tinynuke
nuclearbot	tinynuke
tsh	tinyshell
tzeebot	tinyzbot
tori	torii
nominatustoxicbattery	toxicbattery
nettraveler	travnet
treasurehunter	treasurehunt
huntpos	treasurehunt
treaturehunter	treasurehunt
triangle	triangledb
traingledb	triangledb
triangldb	triangledb
trickster	trickbot
trickybot	trickbot
trick	trickbot
hptrickbot	trickbot
trickbotmodule	trickbot
trickbt	trickbot
trickbotcrypt	trickbot
tidspam	tridspam
trisis	triton
hatman	triton
trochilusrat	trochil
silence	truebot
trytocry	try2cry
sunam	tsunami
kaiten	tsunami
notestuk	turnedup
teamspy	tvspy
tvrat	tvspy
teamviewerent	tvspy
tweakbitdu	tweakbit
minitypeframe	typeframe
typhon	typhonstealer
typhoonstl	typhonstealer
padpin	tyupkin
pinpad	tyupkin
sidkey	tyupkin
tnzbt	tzeebot
ufr	ufrstealer
usteal	ufrstealer
umbral	umbralstealer
rebonum	umbreon
umreon	umbreon
umberon	umbreon
neobrum	umbreon
rombrast	upaskit
upas	upaskit
cutwail	upatre
bublik	upatre
ipatre	upatre
waski	upatre
hpupatre	upatre
bebloh	urlzone
shiotob	urlzone
gozi	ursnif
goziisfb	ursnif
isfb	ursnif
dreambot	ursnif
hpursnif	ursnif
wastenif	ursnif
papras	ursnif
snifula	ursnif
ursnifcrypt	ursnif
vajraeleph	vajraspy
neverquest	vawtrak
catch	vawtrak
grabnew	vawtrak
neverquest2	vawtrak
veeamp	veeam
vegastealer	vega
vegast	vega
vegalocker	vega
proxyvenom	venomproxy
venuslock	venuslocker
venuslk	venuslocker
vermillionstrike	vermilionstrike
vhd	vhdlocker
vhdransomware	vhdlocker
vidarstealer	vidar
vigilantchecker	vigilantcleaner
nabucur	virlock
polyransom	virlock
virransom	virlock
virrnsm	virlock
virlocker	virlock
nabucurobfs	virlock
mondera	virtumonde
monderb	virtumonde
vundo	virtumonde
virux	virut
vetor	virut
vitro	virut
virtob	virut
virutchangeentry	virut
virutchangecall	virut
virtu	virut
nachocheese	vivaciousgift
vjworm	vjw0rm
vpnfilt	vpnfilter
vskim	vskimmer
hesetox	vskimmer
vulture	vultur
ratvultur	vultur
deathransom	wacatac
wannacryptor	wannacry
wanna	wannacry
wannacrypt	wannacry
wcry	wannacry
wanacry	wannacry
ransomwannacry	wannacry
wcryg	wannacry
wanacrypt	wannacry
wanacrypt0r	wannacry
wanacryptor	wannacry
wanacryptbttc	wannacry
wannacryptttc	wannacry
wannacryptcttc	wannacry
wana	wannacry
wanncry	wannacry
wannarenloader	wannaren
wali	wapomi
stration	warezov
warzonerat	warzone
wasted	wastedlocker
wslocker	wastedlocker
wastedlckr	wastedlocker
wastedloadercampaign	wastedlocker
webalt	webalta
webaltatoolbar	webalta
webtbl	webc2table
weontroll	wecontrol
wellmail	wellmess
wmess	wellmess
whirpool	whirlpool
whisperspy	whiskerspy
antiviruspro	windowsantiviruspro
highnoon	winnti
rbdoor	winnti
ribdoor	winnti
atmpot	winpot
winatm	winpot
atmtest	winpot
wirelurk	wirelurker
ddoswirexbotnet	wirex
wndtestupdater	wndtest
woodyrat	woody
wormlckr	wormlocker
chopstick	xagent
splm	xagent
xagfin	xagent
fysbis	xagent
chopstk	xagent
poprd30	xagent
qarallax	xallar
xcasset	xcsset
xtesc	xcsset
xdatrypt	xdata
xanomorph	xenomorph
atmxfsadm	xfsadm
xafade	xfscashncr
firehelper	xhelper
malxmr	xmrig
xmrminer	xmrig
toolxmr	xmrig
xmr	xmrig
xmrigminer	xmrig
xratlocker	xpan
xrat	xpan
xaps	xtunnel
shunnael	xtunnel
lisuife	xtunnel
xtunnelnet	xtunnel
xwormrat	xworm
xwormnet	xworm
minzen	xxmm
yakuzaransomware	yakuza
yanluowang	yanluow
ylwransom	yanluow
yasso	yassoscan
yotoon	yontoo
zcryptor	zcrypt
zebrocyau3	zebrocy
zekapab	zebrocy
gh0st	zegost
farfli	zegost
zeno	zenosearch
0access	zeroaccess
zaccess	zeroaccess
zerolock	zerolocker
zbot	zeus
pwszbot	zeus
zboter	zeus
zbotpatched	zeus
gameoverzeus	zeus
gameoverdga	zeus
xsphinx	zeusopenssl
pandabanker	zeuspanda
panda	zeuspanda
pnda	zeuspanda
zuepan	zeuspanda
ziyang	ziyanzho
ziyazo	ziyanzho
ziyangrat	ziyanzho
deloader	zloader
terdot	zloader
zlader	zloader
zload	zloader
zupdate	zupdater

[GRP]
commentpanda	apt1
commentcrew	apt1
stonepanda	apt10
menupass	apt10
numberedpanda	apt12
ixeshe	apt12
vixenpanda	apt15
mirageteam	apt15
dynamitepanda	apt18
wekby	apt18
turbinepanda	apt26
luckymouse	apt27
emissarypanda	apt27
sednit	apt28
sofacy	apt28
foosace	apt28
fancybear	apt28
dukes	apt29
thedukes	apt29
cozybear	apt29
gothicpanda	apt3
magichound	apt33
oilrig	apt34
oilrignet	apt34
helixkitten	apt34
newsbeef	apt35
ta453	apt35
scarcruft	apt37
chafer	apt39
remixkitten	apt39
winntigroup	apt41
wickedpanda	apt41
bronzeatlas	apt41
tick	bronzebutler
lastacloud	cloudatlas
dubnium	darkhotel
darkhtl	darkhotel
karba	darkhotel
donot	donotteam
aptdonot	donotteam
aptc35	donotteam
dragonfly	energeticbear
crouchingyeti	energeticbear
equatio	equationgroup
egroup	equationgroup
eqgroup	equationgroup
equation	equationgroup
eqtonex	equationgroup
eqgrp	equationgroup
finsev	fin7
finseven	fin7
cycldek	hellsing
heling	hellsing
bytortoiseshell	imperialkitten
tortoiseshell	imperialkitten
ke3chang2	ke3chang
kechang	ke3chang
longhorn	lamberts
lazarus	lazarusgroup
hiddencobra	lazarusgroup
mudwater	muddywater
blockbuster	operationblockbuster
opblockbuster	operationblockbuster
clandestinewolf	operationclandestinewolf
opcleaver	operationcleaver
cloudatlas	operationcloudatlas
cloudhopper	operationcloudhopper
cmajor	operationcmajor
darkseoul	operationdarkseoul
desertfalcon	operationdesertfalcons
desertfalcons	operationdesertfalcons
doubletap	operationdoubletap
dragoncastling	operationdragoncastling
earthkitsune	operationearthkitsune
electricpowder	operationelectricpowder
ephemeralhydra	operationephemeralhydra
exchangemarauder	operationexchangemarauder
opghoul	operationghoul
grizzlysteppe	operationgrizzlysteppe
irontiger	operationirontiger
lotusblossom	operationlotusblossom
nightdragon	operationnightdragon
pawnstorm	operationpawnstorm
poisonedhelmand	operationpoisonedheland
poisonedhurricane	operationpoisonedhurricane
redoctober	operationredoctober
stolenpencil	operationstolenpencil
stolenpen	operationstolenpencil
stolpen	operationstolenpencil
titanrain	operationtitanrain
transparenttribe	operationtransparenttribe
transparentapt	operationtransparenttribe
tropictrooper	operationtropictrooper
tunnelsnake	operationtunnelsnake
wildpressure	operationwildpressure
wiltedtulip	operationwiltedtulip
woolengoldfish	operationwoolengoldfish
droppingelephant	patchwork
strider	projectsauron
4hcrew	putterpanda
rmpntkittn	rampantkitten
telebots	sandworm
voodoobear	sandworm
starcruft	scarcruft
whitebear	skipperturla
promethium	strongpity
strongpity3	strongpity
tonto	tontoteam
uroburos	turla
trula	turla
turlarpc	turla
snake	turla
ekans	turla
mosesstaff	vengefulkitten
vanguardpanda	volttyphoon

[BEH]
ad	adware
adagent	adware
adbundle	adware
adbundler	adware
addisplay	adware
addrop	adware
addropgen	adware
adawre	adware
addware	adware
adinject	adware
adspy	adware
adtool	adware
adw	adware
adwar	adware
adware2	adware
adware5	adware
adwarea	adware
adwareagent	adware
adwareare	adware
adwaredropper	adware
adwarep	adware
adwaret	adware
adwarex	adware
adwre	adware
aware	adware
hfsadware	adware
adwaread	adware
adwarensis	adware
trackware	adware
av	antiav
antiavp	antiav
antiavt	antiav
antiavg	antiav
antiavs	antiav
killav	antiav
killav2	antiav
killav3	antiav
killav4	antiav
killav5	antiav
killav7	antiav
killav9	antiav
killava	antiav
killavb	antiav
killavf	antiav
killavk	antiav
killavl	antiav
killavp	antiav
killavs	antiav
killavt	antiav
killavx	antiav
killavat	antiav
antiavsm	antiav
killavlo	antiav
anti	antifw
anti2	antifw
antifwk	antifw
autorun2	autorun
autorun4	autorun
autorun54	autorun
autorun56	autorun
autorun6	autorun
autoruna	autorun
autoruner	autorun
autorunf	autorun
autorung	autorun
autorunh	autorun
autoruni	autorun
autorunk	autorun
autorunl	autorun
autorunn	autorun
autorunp	autorun
autorunq	autorun
autorunr	autorun
autorunt	autorun
autorunu	autorun
autorunw	autorun
autoruny	autorun
autorunerent	autorun
autoruninf	autorun
autoruns	autorun
otorung	autorun
otorun	autorun
otorun1	autorun
otorun2	autorun
otorun3	autorun
otorun4	autorun
otorun5	autorun
otorun7	autorun
otorun8	autorun
otorun9	autorun
otoruna	autorun
otorune	autorun
otorunk	autorun
otorunn	autorun
otoruno	autorun
otorunp	autorun
otorunq	autorun
autoruna8	autorun
autoruna9	autorun
autorunaa	autorun
autorunac	autorun
autorunae	autorun
autorunai	autorun
autorunaj	autorun
autorunak	autorun
autorunar	autorun
autorunas	autorun
autorunau	autorun
autorunaw	autorun
autorunax	autorun
autoruner1	autorun
autoruner2	autorun
autoruner3	autorun
autorunfc	autorun
autorunfw	autorun
autorungk	autorun
autorunha	autorun
autorunhf	autorun
autorunhg	autorun
autorunhh	autorun
autorunhj	autorun
autorunhq	autorun
autorunhr	autorun
autorunka	autorun
autorunkb	autorun
autorunnd	autorun
autorunnk	autorun
autoruno	autorun
autorunpa	autorun
autorunpe	autorun
autorunri	autorun
autorunsb	autorun
autorunsc	autorun
autorunse	autorun
autorunsg	autorun
autorunsm	autorun
autorunss	autorun
autorunst	autorun
autorunth	autorun
autorunym	autorun
autorunha3	autorun
run	autorun
runonce	autorun
runouce	autorun
rundll	autoun
ackdoor	backdoor
bkdr64	backdoor
bacdkoor	backdoor
backdoo	backdoor
backdooe	backdoor
backdooor	backdoor
backdoor1	backdoor
backdoor10	backdoor
backdoor14	backdoor
backdoor2	backdoor
backdoor3	backdoor
backdoor4	backdoor
backdoor5	backdoor
backdoora	backdoor
backdoorapt	backdoor
backdoord	backdoor
backdoorg	backdoor
backdoorhaxdoor	backdoor
backdoorj	backdoor
backdoorl	backdoor
backdoorm	backdoor
backdoormsil	backdoor
backdoorp	backdoor
backdoorq	backdoor
backdoors	backdoor
backdoort	backdoor
backdooru	backdoor
backdoorv	backdoor
backdoorw	backdoor
backdoorwin32	backdoor
backdoorx	backdoor
backdoory	backdoor
backdoorz	backdoor
backdoot	backdoor
backdor	backdoor
backldoor	backdoor
bck	backdoor
bckdr	backdoor
bdoor	backdoor
bdoor4	backdoor
bkdr	backdoor
backdr	backdoor
bckdoor	backdoor
backdoom	backdoor
backdoorab	backdoor
backdoorad	backdoor
backdoorae	backdoor
backdoorai	backdoor
backdooral	backdoor
backdooram	backdoor
backdooraq	backdoor
backdoordr	backdoor
backdoorgd	backdoor
backdoormsild	backdoor
backdoorup	backdoor
backdoorvb	backdoor
backdoro	backdoor
backdorr	backdoor
jackdos	backdoor
falsesign	badcert
malcert	badcert
badjoker	badjoke
bank	banker
banker1	banker
banker10	banker
banker11	banker
banker12	banker
banker13	banker
banker14	banker
banker15	banker
banker16	banker
banker17	banker
banker2	banker
banker3	banker
banker4	banker
banker5	banker
banker6	banker
banker7	banker
banker8	banker
banker9	banker
bankerb	banker
bankerd	banker
bankere	banker
bankerf	banker
bankerh	banker
bankerp	banker
bankers	banker
bankert	banker
bankeru	banker
bankerx	banker
trojanbanker	banker
trjanbanker	banker
vbanker	banker
bankerbn	banker
bankerbq	banker
bankerbv	banker
bankerdb	banker
bankerfc	banker
bankerha	banker
bankfraud	banker
bankera	banker
bankerax	banker
bankbot	banker
bankeragent	banker
binder2	binder
binderc	binder
blockere	blocker
boo	bootkit
bookit	bootkit
boot1	bootkit
boot2	bootkit
boot	bootkit
bootkitx	bootkit
botnet	bot
browsert	browser
browserx	browser
brmodifier	browsermodifier
broswermodifier	browsermodifier
modifier	browsermodifier
bundl	bundler
bundleapp	bundler
bundlerx	bundler
genbundler	bundler
softwarebundler	bundler
bundlercrtd	bundler
bundleru	bundler
eject	cdeject
adclicks	clicker
adlickr	clicker
adclick	clicker
adclickerscript	clicker
agentclick	clicker
click1	clicker
click14	clicker
click2	clicker
click23	clicker
click3	clicker
click	clicker
clickerk	clicker
adclicer	clicker
adclickr	clicker
adclicke	clicker
adclicker	clicker
adclickera	clicker
adclickeri	clicker
adclickert	clicker
adclickn	clicker
adclckr	clicker
clicker1	clicker
clicker2	clicker
clicker95	clicker
clickera	clicker
clickerl	clicker
clickern	clicker
clickerp	clicker
clickert	clicker
clickeru	clicker
clickerw	clicker
clickjack	clicker
htmlclicker	clicker
rojanclicker	clicker
tjnclicker	clicker
trojanclicker	clicker
adclickb	clicker
adclickerae	clicker
adclickerag	clicker
adclickeram	clicker
clickerb	clicker
trojanclicke	clicker
trojanclickera	clicker
trojanclickerb	clicker
trojanclickerd	clicker
trojanclickerg	clicker
trojanclickerh	clicker
trojanclickerk	clicker
trojanclickerl	clicker
trojanclickerr	clicker
trojanclickert	clicker
trojanclickerv	clicker
trojanclickery	clicker
bitcoinminer	coinminer
bitcoinminerc	coinminer
bitcoinminerf	coinminer
bitcoinminerj	coinminer
bitcoinminerk	coinminer
bitcoinminerl	coinminer
bitcoinminern	coinminer
bitcoinminerp	coinminer
bitminer	coinminer
bitminera	coinminer
btcmine	coinminer
btcminer	coinminer
coinmer	coinminer
coinminera	coinminer
coinminerk	coinminer
coinminerp	coinminer
coinminerq	coinminer
coinminerx	coinminer
cryptominer	coinminer
jswebcoin	coinminer
crypto	coinminer
miner	coinminer
miner2	coinminer
miner3	coinminer
miners	coinminer
monerominer	coinminer
cryptocoinminer	coinminer
bitcoin	coinminer
bitcoinminerb	coinminer
bitcoinminerca	coinminer
bitcoinminerfc	coinminer
bitcoinminerh	coinminer
bitcoinminerpr	coinminer
coinminer64	coinminer
coinminerat	coinminer
coinminerb	coinminer
coinminerc	coinminer
coinminerd	coinminer
coinminerj	coinminer
cryptoy	coinminer
cryptoyp	coinminer
coinmine	coinminer
coins	coinminer
cointheif	cointhief
cointhf	cointhief
constructorkit	constructor
constuctor	constructor
consturctor	constructor
contrustor	constructor
costructor	constructor
corrupt3	corrupt
corrupt4	corrupt
corruptfile	corrupt
corrupto	corrupt
corruptg	corrupt
corruptor	corrupt
crack	cracktool
crack1	cracktool
crack8	cracktool
crypterx	crypter
crypttool	crypter
cryp	cryptor
crpytor	cryptor
crypt	cryptor
cryptz	cryptor
crypt1	cryptor
crypt12	cryptor
crypt2	cryptor
crypt3	cryptor
crypt4	cryptor
crypt49	cryptor
crypt5	cryptor
crypt6	cryptor
crypt7	cryptor
crypt8	cryptor
crypt9	cryptor
cryptom	cryptor
cryptop	cryptor
cryptos	cryptor
cryptow	cryptor
krypt12	cryptor
cryptov	cryptor
cryptool	cryptor
crypticb	cryptor
cryptorv	cryptor
cryptoz	cryptor
polycryptor	cryptor
crypt88	cryptor
crypted	cryptor
cryptost	cryptor
cryptovb	cryptor
cryptowm	cryptor
cryptowp	cryptor
cryptozv	cryptor
dcryptor	cryptor
ransomcrypt	cryptor
tor	cryptor
vbcryptor	cryptor
datacollector	datacollectora
ddoser	ddos
ddoserb	ddos
ddosstf	ddos
ddostool	ddos
ddostools	ddos
ddosagent	ddos
delfile	delfiles
demo1	demo
demo10	demo
demo16	demo
adialer	dialer
dailer	dialer
dbedialers	dialer
dial	dialer
dial30	dialer
dialerb	dialer
dialerd	dialer
dialere	dialer
dialerg	dialer
dialerq	dialer
dialers	dialer
dialert	dialer
dialeru	dialer
dialerv	dialer
dialerx	dialer
dialerz	dialer
dialler	dialer
genericdialer	dialer
porndialer	dialer
porndialers	dialer
dialerbp	dialer
dialerbr	dialer
dialerbt	dialer
dialerdr	dialer
dialerdt	dialer
dialerqk	dialer
dialersa	dialer
dialerst	dialer
dialerti	dialer
dialervb	dialer
dialerxq	dialer
dwnld	download
ddlr	downloader
dlagent	downloader
dldr	downloader
dldr0	downloader
dldr2	downloader
dldr20	downloader
dldr21	downloader
dldr22	downloader
dldr23	downloader
dldr27	downloader
dldr29	downloader
dldr3	downloader
dldr32	downloader
dldr36	downloader
dldr37	downloader
dldr5	downloader
dl	downloader
dloader	downloader
dloaderd	downloader
dloadr	downloader
dloadre	downloader
dloadware	downloader
doawnloader	downloader
downdloader	downloader
downloaderagent	downloader
downloaderb	downloader
downloaderk	downloader
downlader	downloader
downldr	downloader
downldr1	downloader
downldr2	downloader
downldr3	downloader
downldro	downloader
downldrp	downloader
downldrx	downloader
download	downloader
download1	downloader
download11	downloader
download2	downloader
download3	downloader
download4	downloader
downloade	downloader
downloadeer	downloader
downloader1	downloader
downloader10	downloader
downloader11	downloader
downloader12	downloader
downloader13	downloader
downloader14	downloader
downloader15	downloader
downloader16	downloader
downloader17	downloader
downloader18	downloader
downloader19	downloader
downloader2	downloader
downloader20	downloader
downloader21	downloader
downloader22	downloader
downloader23	downloader
downloader24	downloader
downloader25	downloader
downloader26	downloader
downloader27	downloader
downloader28	downloader
downloader29	downloader
downloader3	downloader
downloader30	downloader
downloader31	downloader
downloader32	downloader
downloader33	downloader
downloader34	downloader
downloader35	downloader
downloader36	downloader
downloader37	downloader
downloader38	downloader
downloader39	downloader
downloader4	downloader
downloader40	downloader
downloader41	downloader
downloader42	downloader
downloader43	downloader
downloader44	downloader
downloader45	downloader
downloader5	downloader
downloader6	downloader
downloader7	downloader
downloader8	downloader
downloader9	downloader
downloadera	downloader
downloaderagentb	downloader
downloaderc	downloader
downloadere	downloader
downloaderf	downloader
downloaderg	downloader
downloaderi	downloader
downloaderj	downloader
downloaderp	downloader
downloaderr	downloader
downloaders	downloader
downloadert	downloader
downloaderv	downloader
downloaderx	downloader
downloadf	downloader
downloadl	downloader
downloadp	downloader
downloadr	downloader
downloadt	downloader
downloady	downloader
downloaler	downloader
downlodaer	downloader
dwn	downloader
dwnldr	downloader
dowloader	downloader
downagent	downloader
downlaoder	downloader
downldexe	downloader
downloadagentae	downloader
downloaderai	downloader
doanloaderch	downloader
downloadergd	downloader
downloadervb	downloader
downloads	downloader
downware	downloader
trjndwnlder	downloader
elfdownloader	downloader
gendownloader	downloader
ofdownloader	downloader
troajndownloader	downloader
trojandownloader	downloader
trojdownloader	downloader
trojdwnloader	downloader
ttojandownloader	downloader
downloaderagent2	downloader
trojandownload	downloader
downware2	downloader
downware3	downloader
downwareg	downloader
dldragent	downloader
dldrx	downloader
dlagent2	downloader
dldrop	downloader
dloadera	downloader
dloadrem	downloader
dloadrex	downloader
downldrf	downloader
downldru	downloader
downloadea	downloader
downloadeb	downloader
downloaded	downloader
downloadee	downloader
downloadeg	downloader
downloadeh	downloader
downloadej	downloader
downloader13a	downloader
downloader305	downloader
downloadera2	downloader
downloaderaa	downloader
downloaderac	downloader
downloaderad	downloader
downloaderae	downloader
downloaderag	downloader
downloaderah	downloader
downloaderaj	downloader
downloaderan	downloader
downloaderau	downloader
downloaderay	downloader
downloaderaz	downloader
downloaderbe	downloader
downloaderbf	downloader
downloaderbg	downloader
downloaderbh	downloader
downloaderbho	downloader
downloaderbo	downloader
downloaderbt	downloader
downloaderbu	downloader
downloaderbx	downloader
downloaderby	downloader
downloadercc	downloader
downloadercf	downloader
downloaderch	downloader
downloaderco	downloader
downloadercr	downloader
downloadercs	downloader
downloadercu	downloader
downloadercw	downloader
downloadercy	downloader
downloaderd	downloader
downloaderea	downloader
downloaderee	downloader
downloadereh	downloader
downloaderej	downloader
downloaderep	downloader
downloadereu	downloader
downloaderex	downloader
downloaderez	downloader
downloaderfe	downloader
downloaderfi	downloader
downloaderfl	downloader
downloaderfm	downloader
downloaderfo	downloader
downloaderfp	downloader
downloaderft	downloader
downloaderfz	downloader
downloadergc	downloader
downloadergg	downloader
downloadergh	downloader
downloadergi	downloader
downloadergj	downloader
downloadergk	downloader
downloadergm	downloader
downloadergn	downloader
downloadergq	downloader
downloadergr	downloader
downloadergt	downloader
downloadergv	downloader
downloadergx	downloader
downloadergy	downloader
downloaderh	downloader
downloaderij	downloader
downloaderim	downloader
downloaderiz	downloader
downloaderjb	downloader
downloaderjm	downloader
downloaderjp	downloader
downloaderjw	downloader
downloaderjz	downloader
downloaderkb	downloader
downloaderkd	downloader
downloaderkf	downloader
downloaderkj	downloader
downloaderkk	downloader
downloaderkp	downloader
downloaderkq	downloader
downloaderkz	downloader
downloaderm	downloader
downloaderpc	downloader
downloaderpe	downloader
downloaderph	downloader
downloaderps	downloader
downloaderpu	downloader
downloaderra	downloader
downloaderrb	downloader
downloaderrc	downloader
downloaderrg	downloader
downloaderrh	downloader
downloaderri	downloader
downloaderrl	downloader
downloaderrz	downloader
downloadersb	downloader
downloadersg	downloader
downloadersh	downloader
downloadersj	downloader
downloadersm	downloader
downloadersp	downloader
downloaderss	downloader
downloaderte	downloader
downloaderti	downloader
downloadertj	downloader
downloadertq	downloader
downloadertz	downloader
downloaderu	downloader
downloadervbc	downloader
downloadervbe	downloader
downloadervbh	downloader
downloadervbj	downloader
downloadervbk	downloader
downloadervbm	downloader
downloadervbo	downloader
downloadervbq	downloader
downloadervg	downloader
downloadervk	downloader
downloadervn	downloader
downloadervq	downloader
downloadervr	downloader
downloaderx5	downloader
downloaderx8	downloader
downloaderxa	downloader
downloaderxf	downloader
downloaderxg	downloader
downloaderxi	downloader
downloaderxj	downloader
downloaderxp	downloader
downloaderxt	downloader
downloades	downloader
downloadew	downloader
downloadfb	downloader
downloadfg	downloader
downloadfh	downloader
downloadfj	downloader
downloadfo	downloader
downloadfp	downloader
downloadfr	downloader
downloadfs	downloader
downloadfu	downloader
downloadfv	downloader
downloadla	downloader
downloadld	downloader
downloadlj	downloader
downloadlk	downloader
downloadlp	downloader
downloadlt	downloader
downloadlz	downloader
downloadpa	downloader
downloadpj	downloader
downloadpp	downloader
downloadps	downloader
downloadpt	downloader
downloadpu	downloader
downloadr2	downloader
downloadsa	downloader
downloadse	downloader
downloadsp	downloader
downloadst	downloader
downloadtc	downloader
downloadtj	downloader
downloadtk	downloader
fakedownload	downloader
trojandownloade	downloader
trojandownloaderb	downloader
trojandownloadr	downloader
docdrp	downloader
downloader46	downloader
downloaderjs	downloader
patchload	downloader
reflectiveloader	downloader
dlder	downloader
downlnk	downloader
downloadernet	downloader
drp	dropper
droppr	dropper
mdrop	dropper
multidrop	dropper
muldrop1	dropper
muldrop10	dropper
muldrop11	dropper
muldrop12	dropper
muldrop13	dropper
muldrop14	dropper
muldrop15	dropper
muldrop16	dropper
muldrop17	dropper
muldrop18	dropper
muldrop19	dropper
muldrop2	dropper
muldrop20	dropper
muldrop21	dropper
muldrop3	dropper
muldrop4	dropper
muldrop5	dropper
muldrop6	dropper
muldrop7	dropper
muldrop8	dropper
muldrop9	dropper
muldropa	dropper
dr	dropper
droopper	dropper
droper	dropper
dropoper	dropper
dropper0	dropper
dropper2	dropper
dropper5	dropper
dropper6	dropper
dropper7	dropper
dropper8	dropper
dropperagent	dropper
dropperagenta	dropper
dropperagentc	dropper
dropperagentf	dropper
dropperagento	dropper
dropperagentr	dropper
dropperc	dropper
dropperl	dropper
droppero	dropper
dropperp	dropper
droppert	dropper
dropperv	dropper
droppery	dropper
droppger	dropper
genericdropper	dropper
multidropper	dropper
scriptdroppere	dropper
tjndroppr	dropper
trdropper	dropper
trjndropper	dropper
trojandropper	dropper
trojandroppe	dropper
dropperx	dropper
muldrop	dropper
droppera	dropper
droppercc	dropper
droppercd	dropper
dropperd	dropper
dropperh	dropper
dropperop	dropper
dropperpf	dropper
dropperpq	dropper
droppers	dropper
droppertb	dropper
droppertc	dropper
dropperva	dropper
dropperya	dropper
muldrope	dropper
rooter	dropper
trojandroppera	dropper
trojandropperb	dropper
trojandropperc	dropper
trojandropperd	dropper
trojandroppere	dropper
trojandropperf	dropper
trojandropperg	dropper
trojandropperh	dropper
trojandropperi	dropper
trojandropperj	dropper
trojandropperk	dropper
trojandropperl	dropper
trojandropperm	dropper
trojandroppern	dropper
trojandroppero	dropper
trojandropperp	dropper
trojandropperq	dropper
trojandropperr	dropper
trojandroppers	dropper
trojandroppert	dropper
trojandropperv	dropper
trojandropperw	dropper
trojandropperx	dropper
trojandropperz	dropper
muldrop22	dropper
muldrop23	dropper
muldrop24	dropper
muldrop26	dropper
agentdropper	dropper
mudrop	dropper
nsisdropper	dropper
encoderxor	encoder
encodernet	encoder
expkit5	expkit
exp	exploit
expl	exploit
expl3it	exploit
expl4it	exploit
exploit1	exploit
exploit2	exploit
exploitkit1	exploit
exploitr	exploit
exploits	exploit
exploitt	exploit
exploitx	exploit
explort	exploit
explot	exploit
rtfexploit	exploit
xploit	exploit
expkit	exploitkit
expkit3	exploitkit
exploitkit3	exploitkit
explorerhijacka	explorerhijack
fakealert1	fakealert
fakealert10	fakealert
fakealert12	fakealert
fakealertd	fakealert
fakealertn	fakealert
fakealertq	fakealert
fakealertt	fakealert
fakealertw	fakealert
fakealertx	fakealert
fakealerty	fakealert
fakealertv	fakealert
fakealertnt	fakealert
fakealertqk	fakealert
fakealertta	fakealert
fakealerttn	fakealert
fakealertxl	fakealert
fakealertxn	fakealert
fakealertxq	fakealert
fakealertxw	fakealert
fakealertxz	fakealert
fakealertya	fakealert
fakeavcx	fakeantivirus
fakeavdl	fakeantivirus
fakeantivirus	fakeantivirus
fakeantivirus8	fakeantivirus
fakeantivirusn	fakeantivirus
fakeav	fakeantivirus
fakeav08	fakeantivirus
fakeav09	fakeantivirus
fakeav1	fakeantivirus
fakeav10	fakeantivirus
fakeav11	fakeantivirus
fakeav12	fakeantivirus
fakeav13	fakeantivirus
fakeav14	fakeantivirus
fakeav15	fakeantivirus
fakeav16	fakeantivirus
fakeav17	fakeantivirus
fakeav18	fakeantivirus
fakeav19	fakeantivirus
fakeav2	fakeantivirus
fakeav20	fakeantivirus
fakeav21	fakeantivirus
fakeav22	fakeantivirus
fakeav23	fakeantivirus
fakeav24	fakeantivirus
fakeav25	fakeantivirus
fakeav26	fakeantivirus
fakeav27	fakeantivirus
fakeav28	fakeantivirus
fakeav29	fakeantivirus
fakeav3	fakeantivirus
fakeav30	fakeantivirus
fakeav31	fakeantivirus
fakeav32	fakeantivirus
fakeav33	fakeantivirus
fakeav34	fakeantivirus
fakeav35	fakeantivirus
fakeav36	fakeantivirus
fakeav37	fakeantivirus
fakeav38	fakeantivirus
fakeav39	fakeantivirus
fakeav4	fakeantivirus
fakeav40	fakeantivirus
fakeav41	fakeantivirus
fakeav42	fakeantivirus
fakeav43	fakeantivirus
fakeav44	fakeantivirus
fakeav45	fakeantivirus
fakeav46	fakeantivirus
fakeav47	fakeantivirus
fakeav48	fakeantivirus
fakeav49	fakeantivirus
fakeav5	fakeantivirus
fakeav50	fakeantivirus
fakeav51	fakeantivirus
fakeav52	fakeantivirus
fakeav53	fakeantivirus
fakeav54	fakeantivirus
fakeav55	fakeantivirus
fakeav56	fakeantivirus
fakeav57	fakeantivirus
fakeav59	fakeantivirus
fakeav6	fakeantivirus
fakeav61	fakeantivirus
fakeav62	fakeantivirus
fakeav63	fakeantivirus
fakeav64	fakeantivirus
fakeav65	fakeantivirus
fakeav66	fakeantivirus
fakeav67	fakeantivirus
fakeav68	fakeantivirus
fakeav69	fakeantivirus
fakeav7	fakeantivirus
fakeav70	fakeantivirus
fakeav71	fakeantivirus
fakeav72	fakeantivirus
fakeav73	fakeantivirus
fakeav74	fakeantivirus
fakeav8	fakeantivirus
fakeav9	fakeantivirus
fakeava	fakeantivirus
fakeavb	fakeantivirus
fakeavc	fakeantivirus
fakeavd	fakeantivirus
fakeave	fakeantivirus
fakeavf	fakeantivirus
fakeavg	fakeantivirus
fakeavh	fakeantivirus
fakeavj	fakeantivirus
fakeavl	fakeantivirus
fakeavm	fakeantivirus
fakeavn	fakeantivirus
fakeavo	fakeantivirus
fakeavq	fakeantivirus
fakeavqkm	fakeantivirus
fakeavr	fakeantivirus
fakeavs	fakeantivirus
fakeavt	fakeantivirus
fakeavu	fakeantivirus
fakeavx	fakeantivirus
fakeavjs	fakeantivirus
fakecon1	fakecon
fakecon2	fakecon
fakecon3	fakecon
fakedocd	fakedoc
fakedoce	fakedoc
fakedoca	fakedoc
fakedocu	fakedoc
fakedocx	fakedoc
fakeins	fakeinstall
fakeinst	fakeinstall
fakealer	fakestealer
fakeupdates	fakeupdater
filedelete	filedeleter
fileinfectora	fileinfector
fileinfectorb	fileinfector
fileinfectorc	fileinfector
fileinfectord	fileinfector
flood	flooder
flooder2	flooder
flooderagent	flooder
flooderdelf	flooder
floodericqbomber	flooder
flooderl	flooder
flooderroomdestroyer	flooder
floodervb	flooder
vflooder	flooder
vtflooder	flooder
vflood	flooder
vtflooderhv	flooder
fraud0	fraud
fraud1	fraud
fraud7	fraud
fraudload	fraud
fraudloada	fraud
fraudloadb	fraud
fraudloadc	fraud
fraudloadg	fraud
fraudloadh	fraud
fraudloadk	fraud
fraudloadl	fraud
fraudloadn	fraud
fraudloadt	fraud
fraudtool	fraud
fraudtoold	fraud
fraudtoolz	fraud
fraudloadab	fraud
fraudloadaf	fraud
fraudloadag	fraud
fraudloadam	fraud
fraudloadbn	fraud
fraudloadc1	fraud
fraudloadi	fraud
fraudloadka	fraud
fraudloadm	fraud
fraudloado	fraud
fraudloadx	fraud
fraudtoolb	fraud
fraudtoole	fraud
fraudtoolg	fraud
fraudtooli	fraud
fraudtoolk	fraud
fraudrop	fraud
ftpget	ftp
serverftp	ftp
game2	game
game23	game
gamehackf	gamehack
gamehackg	gamehack
gamehackh	gamehack
gamehacki	gamehack
gamehackt	gamehack
gamethief1	gamethief
gamethiefa	gamethief
gamethiefd	gamethief
gamethiefo	gamethief
gamethieft	gamethief
gamethiefx	gamethief
tjngmethief	gamethief
trojangamethief	gamethief
hack	hacktool
hack11	hacktool
hack7	hacktool
hack99	hacktool
hacktoolj	hacktool
bhacktool	hacktool
hacktoolx	hacktool
hackingtool	hacktool
hacktol	hacktool
hacktoola	hacktool
hacktoolhacktool	hacktool
hacktools	hacktool
hacktoolv	hacktool
hktl	hacktool
htool	hacktool
cheattool	hacktool
hackingtools	hacktool
hacktoolab	hacktool
hacktoolag	hacktool
hacktoolah	hacktool
hacktoolam	hacktool
hacktoolo	hacktool
hacktoolsa	hacktool
hacktoolw	hacktool
hacktoolxa	hacktool
hacktooly	hacktool
hacktoolz	hacktool
hiddapp	hiddenapp
hiddenlink	hidelink
hidelinkk	hidelink
prochide	hideproc
hijacker2	hijacker
smshoax	hoax
hotbar2	hotbar
hotbar5	hotbar
hotbar6	hotbar
hotbare	hotbar
hotbarr	hotbar
hotbarem	hotbar
hotbarri	hotbar
hfsiframescript	iframe
iframe6	iframe
iframea	iframe
iframeb	iframe
iframebo	iframe
iframebof	iframe
iframebw	iframe
iframed	iframe
iframef	iframe
iframeinject	iframe
iframem	iframe
iframen	iframe
iframer	iframe
iframere	iframe
iframeref	iframe
iframeref1	iframe
iframeref2	iframe
iframeref3	iframe
iframeref4	iframe
iframeref5	iframe
iframeref6	iframe
iframeref7	iframe
iframeref8	iframe
iframeref9	iframe
iframes	iframe
iframev	iframe
iframey	iframe
iframead	iframe
iframebo3	iframe
iframebof2	iframe
iframebof3	iframe
iframebog	iframe
iframeboh	iframe
iframebor	iframe
iframedl	iframe
iframedq	iframe
iframefa	iframe
iframefv	iframe
iframefw	iframe
iframefx	iframe
iframema	iframe
iframeme	iframe
iframemz	iframe
iframer	iframe
framer	iframe
infectedh	infected
infect	infector
infect2	infector
infector19	infector
infector20	infector
infectr	infector
infecto	infector
infector13	infector
infector18	infector
infecton	infector
infectory	infector
ceeinject	injector
delfinjectb	injector
delfinjectf	injector
delfinjecth	injector
delfinjectl	injector
delfinjectt	injector
delfinjectu	injector
delfinjectw	injector
delfinjecty	injector
inject	injector
inject1	injector
inject2	injector
inject3	injector
inject4	injector
inject64	injector
injecter	injector
injectq	injector
injectr	injector
injects	injector
injectt	injector
vbinjectb	injector
injecte	injector
infectorr	injector
infectorx	injector
injecta	injector
injecth	injector
injectk	injector
injecto	injector
injector1	injector
injector10	injector
injector2	injector
injector3	injector
injector4	injector
injector5	injector
injector6	injector
injector7	injector
injector8	injector
injector9	injector
injectora	injector
injectorb	injector
injectorc	injector
injectord	injector
injectore	injector
injectorf	injector
injectorg	injector
injectori	injector
injectork	injector
injectorn	injector
injectort	injector
injectoru	injector
injectorw	injector
injectorx	injector
injectory	injector
injectorz	injector
autoinj	injector
autoinj01	injector
autoinj02	injector
autoinj03	injector
autoinj04	injector
autoinj05	injector
cryptinject	injector
kryptinject	injector
delfinjectbb	injector
delfinjectbd	injector
delfinjectbe	injector
delfinjectbh	injector
delfinjectbi	injector
delfinjectbj	injector
delfinjectbo	injector
delfinjectbt	injector
delfinjectbu	injector
delfinjectbv	injector
delfinjectby	injector
delfinjectha	injector
delfinjecttn	injector
injectad	injector
injected	injector
injectes	injector
injecteu	injector
injectex	injector
injecton	injector
injectorab	injector
injectorad	injector
injectorae	injector
injectorag	injector
injectorak	injector
injectorat	injector
injectorau	injector
injectorav	injector
injectorbb	injector
injectorbc	injector
injectorbf	injector
injectorbn	injector
injectorbq	injector
injectorbt	injector
injectorca	injector
injectorcf	injector
injectorci	injector
injectorcl	injector
injectorcr	injector
injectorcs	injector
injectorct	injector
injectorcu	injector
injectordo	injector
injectordp	injector
injectoref	injector
injectorfc	injector
injectorgx	injector
injectorih	injector
injectortl	injector
injectortm	injector
injectorul	injector
injectos	injector
injectox	injector
injectqq	injector
injectri	injector
injectsu	injector
vbinjectba	injector
vbinjectbb	injector
vbinjectbc	injector
vbinjectbg	injector
vbinjectbh	injector
vbinjectbi	injector
vbinjectbm	injector
vbinjectbp	injector
vbinjectbw	injector
vbinjectby	injector
inject5	injector
dllinjector	injector
dllinject	injector
aitinject	injector
adinstaller	installer
installm	installer
instally	installer
installad	installer
adinstall	installer
bundleinstaller	installer
install	installer
pupinstaller	installer
toolbarinstaller	installer
installapp	installer
installc	installer
appinstall	installer
adinstalla	installer
adinstalld	installer
adinstalle	installer
install6	installer
installa	installer
installapps	installer
installb	installer
installco	installer
installcr	installer
installe	installer
installer4	installer
installer6	installer
installera	installer
installerc	installer
installere	installer
installerex	installer
installers	installer
installert	installer
installerx	installer
installex	installer
installf	installer
installi	installer
installiq	installer
installme	installer
installmet	installer
installq	installer
installr	installer
installrx	installer
installs	installer
installt	installer
installx	installer
installyu	installer
clientirc	ircbot
irc	ircbot
mirc	ircbot
ircbotha	ircbot
ircbottn	ircbot
ircbottq	ircbot
ircprogram	ircbot
ircbot1	ircbot
ircbot2	ircbot
ircbot3	ircbot
ircbot4	ircbot
ircbota	ircbot
ircbotb	ircbot
ircbotc	ircbot
ircbotd	ircbot
ircbotg	ircbot
ircboth	ircbot
ircboth1	ircbot
ircboti	ircbot
ircbotk	ircbot
ircbotn	ircbot
ircboto	ircbot
ircbotp	ircbot
ircbots	ircbot
ircbott	ircbot
ircbottm	ircbot
ircbotto	ircbot
ircbottt	ircbot
ircbotu	ircbot
ircbotv	ircbot
ircbotx	ircbot
ircboty	ircbot
ircbotz	ircbot
ircbotaa	ircbot
ircbotac	ircbot
ircbotae	ircbot
ircbotag	ircbot
ircbotam	ircbot
ircbotax	ircbot
ircbotbb	ircbot
ircbotbc	ircbot
ircbotbg	ircbot
ircbotct	ircbot
ircbotdj	ircbot
ircbotsm	ircbot
mirc3	ircbot
badjoke	joke
badjokeb	joke
jokeapp	joke
jokeprogram	joke
joketool	joke
jokeprograms	joke
keylog	keylogger
keylog2	keylogger
keylog32	keylogger
keylog95	keylogger
keyloga	keylogger
keylogs	keylogger
keylogap	keylogger
keylogaz	keylogger
keylogg	keylogger
keyloggera	keylogger
keyloggere	keylogger
keyloggerg	keylogger
keyloggerh	keylogger
keyloggerj	keylogger
keyloggero	keylogger
keyloggers	keylogger
keyloggerw	keylogger
keylogm	keylogger
keylogo	keylogger
keylogge	keylogger
keyloggerac	keylogger
keyloggerx	keylogger
keyloggr	keylogger
keylogr	keylogger
vbkeylog	keylogger
killfiles2	killfiles
killproc2	killproc
killproce	killproc
killprocs	killproc
crypton	krypt
cryptone	krypt
binlodr	loader
spyloader	loader
oader	loader
lockscreenb	lockscreen
mail	mailer
massmailer	mailer
mail2	mailer
mailfindera	mailfinder
misleadingx	misleading
monitoring	monitoringtool
montool	monitoringtool
nettools	nettool
network1	network
networkd	network
networks	network
networkw	network
trojannotifier	notifier
nuke	nuker
nuke0	nuker
nuke5	nuker
malpacked	packed
malpacked2	packed
malpacked3	packed
malpacked4	packed
malpacked5	packed
malpacked6	packed
malpacked7	packed
packedent	packed
maliciouspacker	packed
multipacked	packed
pack	packed
packed2	packed
packed3	packed
packer	packed
packer2	packed
packer3	packed
packert	packed
pepack	packed
malpackedb	packed
malpackedc	packed
malpackedd	packed
pack2	packed
packeda	packed
packedap	packed
packednet	packed
psw	passwordstealer
pws	passwordstealer
pwstool	passwordstealer
pswtroj	passwordstealer
pwstrojan	passwordstealer
pwtool	passwordstealer
pswtool	passwordstealer
pwsteal	passwordstealer
passwords	passwordstealer
passwordstealera	passwordstealer
passwordstealerd	passwordstealer
passwordstealerw	passwordstealer
pwstealer	passwordstealer
pwstealer1	passwordstealer
pwstealer2	passwordstealer
pwstealer3	passwordstealer
pwstealerx	passwordstealer
password	passwordstealer
trojanpsw	passwordstealer
trojanpws	passwordstealer
pwsteal1	passwordstealer
pwstealc	passwordstealer
pwsteald	passwordstealer
pwsteale	passwordstealer
pwstealg	passwordstealer
pwstealh	passwordstealer
pwstealj	passwordstealer
trojanpasswordstealer	passwordstealer
passview	passwordstealer
browserpassview	passwordstealer
mailpassview	passwordstealer
passdump	passwordstealer
patchedy	patcher
patcher2	patcher
patcherd	patcher
patcherx	patcher
pepatch	patcher
patch	patcher
patch1	patcher
pepatche	patcher
pepatcht	patcher
perfloge	perflog
abphisher	phishing
fishing	phishing
phish	phishing
phish1	phishing
phisher	phishing
phishing11	phishing
phishing12	phishing
phishing13	phishing
phishing14	phishing
phishing15	phishing
phishing16	phishing
phishing17	phishing
phishing18	phishing
phishing19	phishing
phishingx	phishing
porntool	porn
porn1	porn
trojanpos	pos
proxy2	proxy
proxy3	proxy
torjanproxy	proxy
trjnproxy	proxy
trojanproxy	proxy
potentiallyunwanted	pua
puaadvertising	pua
puabundler	pua
puadlmanager	pua
unwanted	pua
uws	pua
garyware	pua
grayware	pua
encodedransom	ransom
ran	ransom
raas	ransom
ranosm	ransom
ransom32	ransom
ransom64	ransom
ransoma	ransom
ransomare	ransom
ransomb	ransom
ransome	ransom
ransommsil	ransom
ransoms	ransom
ransomtool	ransom
ransomw	ransom
ransomware	ransom
ransomx	ransom
rasnom	ransom
ransomeware	ransom
ransomheur	ransom
tjnransom	ransom
trojanransom	ransom
ransomer	ransom
filcoder	ransom
filecoder	ransom
filecrypt	ransom
filecryptor	ransom
filecrypter	ransom
screenlocker	ransom
filelocker	ransom
ransomab	ransom
ransomay	ransom
ransombt	ransom
ransomed	ransom
ransomsy	ransom
locker	ransom
ransombuilder	ransom
ransomkd	ransom
filecoderprot	ransom
ransm	ransom
ransomlock	ransom
cryptoransomeware	ransom
remoteaccesstool	rat
remadm	rat
remoteadmina	rat
remoteadminb	rat
remoteadminx	rat
redir	redirector
redir1	redirector
redir5	redirector
jsredir	redirector
redirect	redirector
redirect5	redirector
redirection	redirector
redirecto	redirector
redirectorr	redirector
redirectors	redirector
redirectr	redirector
redirects	redirector
refresh2	refresh
remoteadmin	remoteshell
ra	remoteshell
rahack	remoteshell
rahack2	remoteshell
remotetool	remoteshell
remoteaccess	remoteshell
remotecode	remoteshell
shell	remoteshell
msfshell	remoteshell
msshellcode	remoteshell
reverseshell	remoteshell
radminer	remoteshell
radmin	remoteshell
remoteexec	remoteshell
remoxec	remoteshell
remote	remoteshell
shellbot	remoteshell
shellcoderunner	remoteshell
abrisk	riskware
rishware	riskware
risk	riskware
risktool	riskware
securityrisk	riskware
risktools	riskware
rogues	rogue
rougue	rogue
rogueantispyware	rogue
rogueware	rogue
rogue3	rogue
ratrogue	rogue
rkit	rootkit
ntrootkit	rootkit
ntrootkitt	rootkit
rootkit10	rootkit
rootkit2	rootkit
rootkit40	rootkit
rootkit5	rootkit
rootkita	rootkit
rootkitc	rootkit
rootkitd	rootkit
rootkitf	rootkit
rootkitq	rootkit
rootkits	rootkit
rootkitt	rootkit
rootkitx	rootkit
rootkitz	rootkit
rtk	rootkit
rtkt	rootkit
rkit1	rootkit
rootkit2k	rootkit
rootkitax	rootkit
rootkitdp	rootkit
rootkitdr	rootkit
rootkitdrv	rootkit
rootkitfg	rootkit
rootkitsm	rootkit
trojanrunner	runner
runnera	runner
sshscan	scanner
screensavers	screensaver
search3	searcher
search42	searcher
search	searcher
searche	searcher
selfdelf	selfdel
seo	seohide
server0	server
server1	server
server12	server
server2	server
server22	server
serverx	server
serverxb	server
serverxc	server
serverxd	server
serverxe	server
servstart2	servstart
servstarta	servstart
servstartd	servstart
servstartf	servstart
servstartg	servstart
servstarth	servstart
servstarti	servstart
servstartj	servstart
servstartl	servstart
servstartn	servstart
servstartr	servstart
servstarts	servstart
servstartt	servstart
servstartv	servstart
servstartw	servstart
servstartz	servstart
servstartah	servstart
servstartai	servstart
servstartaj	servstart
servstartak	servstart
servstartal	servstart
servstartao	servstart
servstartri	servstart
smscore	sms
smsplac	sms
trojansms	sms
smsagent	sms
smsbot	sms
smsspy	sms
smsthief	sms
clientsmtp	smtp
sniff	sniffer
sniffer1	sniffer
sniffery	sniffer
sftwrbndlr	softwarebundler
sftwrebndlr	softwarebundler
softwarebndlr	softwarebundler
softwarebundlr	softwarebundler
softwarebunlder	softwarebundler
softwbndlr	softwarebundler
swbundlr	softwarebundler
spam1	spam
spam6	spam
spammer	spam
spamtool	spam
spamtoolt	spam
spams	spam
spy	spyware
spy005568	spyware
spy009152	spyware
spy014784	spyware
spy020416	spyware
spy028096	spyware
spy031699	spyware
spy039360	spyware
spy039852	spyware
spy064960	spyware
spy07008	spyware
spy072128	spyware
spy073152	spyware
spy078784	spyware
spy08032	spyware
spy084928	spyware
spy085440	spyware
spy09056	spyware
spy101488	spyware
spy112576	spyware
spy114112	spyware
spy122304	spyware
spy134592	spyware
spy135952	spyware
spy138688	spyware
spy144352	spyware
spy14688	spyware
spy146880	spyware
spy151152	spyware
spy15200	spyware
spy155072	spyware
spy155584	spyware
spy16736	spyware
spy17248	spyware
spy179648	spyware
spy181184	spyware
spy18272	spyware
spy183744	spyware
spy18784	spyware
spy191936	spyware
spy19277	spyware
spy195520	spyware
spy196032	spyware
spy204717	spyware
spy204736	spyware
spy20832	spyware
spy208320	spyware
spy212416	spyware
spy216512	spyware
spy21856	spyware
spy223688	spyware
spy22880	spyware
spy23872	spyware
spy245184	spyware
spy25952	spyware
spy261568	spyware
spy26976	spyware
spy269760	spyware
spy283584	spyware
spy290240	spyware
spy294336	spyware
spy295360	spyware
spy30048	spyware
spy30560	spyware
spy306624	spyware
spy308160	spyware
spy311744	spyware
spy317888	spyware
spy323008	spyware
spy327488	spyware
spy343488	spyware
spy347584	spyware
spy350656	spyware
spy351680	spyware
spy363968	spyware
spy364488	spyware
spy376256	spyware
spy38240	spyware
spy384448	spyware
spy38752	spyware
spy390080	spyware
spy40800	spyware
spy41312	spyware
spy41336	spyware
spy425408	spyware
spy433088	spyware
spy4336	spyware
spy43360	spyware
spy437696	spyware
spy442816	spyware
spy44760	spyware
spy462272	spyware
spy472000	spyware
spy47968	spyware
spy482752	spyware
spy48480	spyware
spy49504	spyware
spy497600	spyware
spy51552	spyware
spy521152	spyware
spy533952	spyware
spy54393	spyware
spy552384	spyware
spy55648	spyware
spy57048	spyware
spy58208	spyware
spy5872	spyware
spy589760	spyware
spy6351	spyware
spy65280	spyware
spy65824	spyware
spy66400	spyware
spy67936	spyware
spy6896	spyware
spy69984	spyware
spy705984	spyware
spy727343	spyware
spy74592	spyware
spy75104	spyware
spy75616	spyware
spy76621	spyware
spy78176	spyware
spy80224	spyware
spy80717	spyware
spy82768	spyware
spy831127	spyware
spy83600	spyware
spy84320	spyware
spy85344	spyware
spy865728	spyware
spy86880	spyware
spy87904	spyware
spy880064	spyware
spy88416	spyware
spy8928	spyware
spy8944	spyware
spy93024	spyware
spy95584	spyware
spy96608	spyware
spy96636	spyware
spy97632	spyware
spyagent	spyware
spyare	spyware
spywaret	spyware
spywarex	spyware
sypyware	spyware
trojanspy	spyware
tspy	spyware
tspy64	spyware
spy182720	spyware
spywareg	spyware
spywareq	spyware
spywarexp	spyware
spybot	spyware
spybotnet	spyware
bruter	sshbruteforce
bruteforce	sshbruteforce
ssh	sshbruteforce
sshbru	sshbruteforce
sshbrute	sshbruteforce
startpage0	startpage
startpage1	startpage
startpage2	startpage
startpage3	startpage
startpage4	startpage
startpage5	startpage
startpage6	startpage
startpagea	startpage
startpaged	startpage
startpagef	startpage
startpagei	startpage
startpagel	startpage
startpagem	startpage
startpageq	startpage
startpager	startpage
startpages	startpage
startpaget	startpage
startpageu	startpage
startpagex	startpage
startpagey	startpage
startpageaa	startpage
startpageab	startpage
startpageac	startpage
startpageae	startpage
startpageaf	startpage
startpageai	startpage
startpageal	startpage
startpageam	startpage
startpageap	startpage
startpageb	startpage
startpagedb	startpage
startpagedc	startpage
startpagedf	startpage
startpagedu	startpage
startpagefc	startpage
startpageih	startpage
startpagej	startpage
startpagemf	startpage
startpageri	startpage
startpagety	startpage
startpageu1	startpage
startpagev	startpage
coinstealer	stealer
steale	stealer
infosteal	stealer
infostealer	stealer
infostealer2	stealer
infostealera	stealer
infostealerf	stealer
infostealern	stealer
infostealerq	stealer
infostealerz	stealer
stealera	stealer
stealers	stealer
stealerx	stealer
steal	stealer
coinsteal	stealer
infosteale	stealer
infostealerab	stealer
infostealerp	stealer
infostealeru	stealer
infostealery	stealer
stealerd	stealer
stealerc	stealer
stealgen	stealer
pswstealer	stealer
poscardstealer	stealer
stealernet	stealer
toolbaro	toolbar
toolbarx	toolbar
toolbat	toolbar
multitoolbwar	toolbar
toolbart	toolbar
webtoolbar	toolbar
toolbars	toolbwar
trackr	tracker
abtrojan	trojan
horse	trojan
horse1	trojan
horse2	trojan
horse3	trojan
horse4	trojan
tr	trojan
trj	trojan
trjoan	trojan
troj	trojan
roj64	trojan
troja	trojan
trojaapt	trojan
trojain	trojan
trojan2	trojan
trojan3	trojan
trojan4	trojan
trojan5	trojan
trojanapt	trojan
trojanx	trojan
trojware	trojan
gentroj	trojan
smalltroj	trojan
trojan1	trojan
apt	trojan
proxychanger	trojan
smalltrojh	trojan
tojan	trojan
troajn	trojan
troj64	trojan
trojan6	trojan
trojan7	trojan
trojanp	trojan
trojans	trojan
trojanxp	trojan
vbtrojan	trojan
vbtrojan3	trojan
sxtrojan	trojan
trojna	trojan
trojane	trojanes
trojaner	trojanes
trojaneu	trojanes
updateagent	updater
vbinj	vbinject
vbinj1	vbinject
vbinjecta	vbinject
vbinjectc	vbinject
vbinjectd	vbinject
vbinjectg	vbinject
vbinjectm	vbinject
vbinjectp	vbinject
vbinjectt	vbinject
vbinjectab	vbinject
vbinjectac	vbinject
vbinjectak	vbinject
vbinjectan	vbinject
vbinjectaq	vbinject
vbinjectar	vbinject
vbinjectay	vbinject
vbinjectcc	vbinject
vbinjectcf	vbinject
vbinjectci	vbinject
vbinjectcn	vbinject
vbinjectcs	vbinject
vbinjectdb	vbinject
vbinjectdd	vbinject
vbinjectdg	vbinject
vbinjectdh	vbinject
vbinjectdm	vbinject
vbinjectdo	vbinject
vbinjectdp	vbinject
vbinjectdq	vbinject
vbinjectdz	vbinject
vbinjectf	vbinject
vbinjectgb	vbinject
vbinjectgg	vbinject
vbinjectgq	vbinject
vbinjectgr	vbinject
vbinjectgu	vbinject
vbinjectgw	vbinject
vbinjectmf	vbinject
vbinjectmm	vbinject
virtools	virtool
virtoolx	virtool
virtl	virtool
virtoot	virtool
vtool	virtool
fileinfector	virus
oldvirus	virus
virus0	virus
virus02	virus
virus04	virus
virus05	virus
virus06	virus
virus2	virus
virus7	virus
virus9	virus
virus90	virus
virusorg	virus
fileinfectorx	virus
webshel	webshell
webshellgen	webshell
phpwebshel	webshell
phpwebshell	webshell
diskwipe	wiper
diskwiper	wiper
erasembr	wiper
diskwriter	wiper
killmbr	wiper
wipmbr	wiper
emailworm	worm
imworm	worm
networm	worm
networma	worm
networmb	worm
p2pworm	worm
scriptworm	worm
worm07	worm
worm1	worm
worm2	worm
worm3	worm
worm32	worm
worm4	worm
worm5	worm
worm6	worm
worm60	worm
worm64	worm
worm98	worm
wormapt	worm
wormbat	worm
wormdos	worm
wormspy	worm
wormsuljsuljsuljs	worm
wormwinnt	worm
worw	worm
wrm	worm
wrom	worm
vbsworm	worm
wormvbs	worm
emailworma	worm

[FILE]
am97	a97m
adnroidos	android
andr	android
andrgedma	android
androido	android
androidos	android
androidos2	android
androidosl	android
androide	android
archived	archive
archiveo	archive
archiver	archive
acad	autocad
autit	autoit
autoitcrypt	autoit
autoitu	autoit
autoitscript	autoit
autoitinject	autoit
autoitlock	autoit
autoit2	autoit
autoit3	autoit
autoit5	autoit
autoitgen	autoit
autoitt	autoit
alisp	autolisp
lisp	autolisp
copak	codecpack
delphi5	delphi
delphi7	delphi
docdown	doc
embeddedjsinocxinworddoc	doc
sharedofficedocuments	doc
behaveslikedos	dos
dos32	dos
trojandos	dos
dotnetcrypt	dotnet
driverpack	driver
aself	elf
e32	elf
elf32	elf
elf64	elf
elfarm32	elf
elfarm64	elf
xf	excelformula
fdos0	fdos
hllo1	hllo
hllo2	hllo
hllp	hllo
hllw	hllo
hmtl	html
htm	html
html5	html
htmlhelpcontrol	html
inno	innosetup
javagen	java
obfusjava	java
jpeg	jpg
javascript	js
jsagent	js
jscript	js
jsenc	js
linux64	linux
genautorunlnkfile	lnk
lnkdown	lnk
winlnk	lnk
macnist	macos
mac	macosx
osx	macosx
osx32	macosx
macdownload	macosx
macdownloader	macosx
macinst	macosx
macinstaller	macosx
maclauncher	macosx
macos	macosx
asmacro	macro
macro01	macro
macro40	macro
macrodown	macro
xlsmacro	macro
xm	macroexcel
wm	macroword
excel	msexcel
excel4	msexecl
msil10	msil
msil2	msil
msil3	msil
msil4	msil
msil5	msil
msil6	msil
msil7	msil
msil8	msil
msil9	msil
msilkrypt	msil
msilkrypt02	msil
msilkrypt03	msil
msilkrypt04	msil
msilkrypt05	msil
msilkrypt08	msil
msilkrypt09	msil
msilkrypt10	msil
msilkrypt11	msil
msilkrypt12	msil
msilkrypt13	msil
msilkrypt14	msil
msilkrypt15	msil
msilkrypt16	msil
msilkrypt17	msil
msilkrypt18	msil
msil11	msil
msilzilla	msil
msildyn	msil
msilfc	msil
macrooffice	msoffice
msoffice8	msoffice
office	msoffice
office97	msoffice
word	msword
multios	multi
packaged	package
packager	package
packages	package
pdfjs	pdf
pdfka	pdf
pdfview	pdf
fakepdf	pdf
malpdf	pdf
pdfer	pdf
piedief	pdf
malpe	pe
malpe1	pe
malpe10	pe
malpe11	pe
malpe16	pe
malpe17	pe
malpe19	pe
malpe2	pe
malpe20	pe
malpe21	pe
malpe22	pe
malpe23	pe
malpe24	pe
malpe25	pe
malpe26	pe
malpe29	pe
malpe3	pe
malpe30	pe
malpe31	pe
malpe32	pe
malpe33	pe
malpe34	pe
malpe35	pe
malpe36	pe
malpe37	pe
malpe4	pe
malpe5	pe
malpe6	pe
malpe7	pe
malpe8	pe
malpe9	pe
perl2	perl
virusperl	perl
phpshell	php
phpsmall	php
ps	powershell
psh	powershell
pshell	powershell
powsershell	powershell
pwrsh	powershell
psloader	powershell
powermacro	powershell
powershellrunner	powershell
psload	powershell
py	python
pyc	python
pyagent	python
pyinstaller	python
ruby13	ruby
scriptsh	script
591591script	script
asscript	script
malscript	script
scr	script
script00	script
script2	script
scripts	script
scritp	script
sf	sfx
shellcodef	shellcode
smbos	symbos
symb	symbos
symbos9	symbos
smbos4	symbos
smbos2	symbos
smbos3	symbos
symbian	symbos
txt	text
text6	text
text8	text
unix7	unix
vb	vb
vb2	vb
vbagent	vb
vbcrypt	vb
vbcryptb	vb
vbgen	vb
vbgeneric	vb
vbgent	vb
vbinf	vb
vbkrypt	vb
vbkrypt2	vb
vbkrypt3	vb
vbkrypt4	vb
vbkrypt5	vb
vbkrypt7	vb
vbkrypt8	vb
vbkrypta	vb
vbkryptw	vb
vbkryptx	vb
vbobfus	vb
vbobfuse	vb
vbs2html	vb
vbcrypth	vb
vbcryptn	vb
vbcrypto	vb
vbkrypt17	vb
vbscript	vbs
aw97m	w97m
mw97	w97m
w79m	w97m
wm97	w97m
pp97m	w97m
w32	win32
wi32	win32
wiin32	win32
win31	win32
win32x	win32
winm32	win32
wni32	win32
wwin32	win32
win32file	win32
hw32	win32
w64	win64
hw64	win64
w95	win95
win9x	win95
winnt32	winnt
excel97	x97m
mx97	x97m
o97m	x97m
xmldoc	xml

[PACK]
armadillo17	armadillo
armadillo3	armadillo
armadillo42	armadillo
armadillon	armadillo
aspack1	aspack
aspack212	aspack
enigmaprotector1	enigmaprotector
mfsg	fsg
maskpet	maskpe
mysticcompressor	mystic
npack1	npack
nsanti2	nsanti
nsantix	nsanti
nsantit	nsanti
nsantis	nsanti
nsantir	nsanti
nsantiq	nsanti
nsantip	nsanti
nsantim	nsanti
nsantil	nsanti
nsantik	nsanti
nsantih	nsanti
nsantihi	nsanti
nsantihj	nsanti
nsantihm	nsanti
nsis1	nsis
nspack	nspack
nspack1	nspack
nspack2	nspack
nspack3	nspack
nspackt	nspack
ntkrnl	ntkrnlpacker
ntkrnlpa	ntkrnlpacker
ntkrnlp	ntkrnlpacker
ntkrnl0	ntkrnlpacker
packman1	packman
pearmort	pearmor
pec1	pecompact
pespinv	pespin
pespinv0	pespin
pespinv1	pespin
petite1	petite
petite2	petite
rlpack1	rlpack
spack2	spack
spack3	spack
telock1	telock
themidaa	themida
upack0	upack
upack39	upack
mupx	upx
unknownupxmodifyer	upx
vmppacker	vmprotect
vmprotect1	vmprotect
vmprotectt	vmprotect
vmprotbad	vmprotect
yoda1	yoda
yodabased	yoda
yodacryptor	yoda
yodaprot	yoda
yodaprotector	yoda
yzpack1	yzpack

